???????????????
?___???????????
?_?___________?
?___?????????_?
?????___?_____?
?_____?_?_?????
?___?___?_?___?
?___?????_?_?_?
?___?_____?___?
?___?_??????_??
?___?_?_______?
?_____________?
?___?_?_______?
?????^?????????
???????????????