???????????????
???????????????
???????????????
???????????????
???????????????
???????????????
?______^______?
?___?__?____?_?
?______?______?
?_????????____?
?________?____?
?_?______?____?
?________^____?
?????^?????????
???????????????