???????????????
???????????????
???????????????
???????????????
???????????????
???????????????
???????????????
?_______d^d___?
?___?___^d^___?
?_???_________?
?__??______?d^?
?___________^d?
?___________d^?
?????^?????????
???????????????