?????????????????????????
?____________??_________?
?____________??_?_____?_?
?____________??_________?
?____________??_________?
?____________??_________?
?____________??_________?
?___??_______?????__?????
?___??_______?????__?????
?___??__________________?
?___??__________________?
?___??_______??_________?
?___??_______??_________?
?___??_______??_________?
?_?_??_______??_________?
?___??_______??_________?
?????????^???????????????
?????????????????????????