??___d__??
??????????
??______??
?________?
??______??
??????????
??______??