树树树树树道道道道草草草草道道水水树树树树树树树树树树树树树树树树树树树树树树树树石石石石石石石石石石石石石石石石
树树树树树草草草草草草草草道道水水树树树树树树树树树树树树树树树树树树树树树树树树石石石石石石石石石石石石石石石石
树树树树树草草草草草草草草道道水水树树树树树树树树树树树树树树树树树树树树树树树树石石石石石石石石石石石石石石石石
树树树树树草草草草草草道道道道水水树树树树树树树树树树树树树树树树树树树树树树树树石石石石石石石石石石石石石石石石
树树树树树草草草草草草道道道道水水树树树树树树树树树树树树树树树树树树树树树树树石石石石石石石石石石石石石石石石石
树树树树树草草土土土土道道草草水水树树树树树树树树树树树树树树树树树树树树树树树石石石石石石石石石石石石石石石石石
树树树树树草草土飾土土道道草草水水树树树树树树树树树树树树树树树树树树树树树树树石石石石石石石石石石石石石石石石石
树树树树树草草道道道道道道草草水水树树树树树树树树树树树树树树树树树树树树树树树石石石石石石石石石石石石石石石石石
树树树树树草草道道道道道道草草水水树树树树树树树树树树树树树树树树树树树树树树石石石石石石石石石石石石石石石石石石
水水水水水水水水道道水水水水水水水树树树树树草草草草草草草草草草草树树树树树树石石石石石石石石石石石石石石石石石石
水水水水水水水水道道水水水水水水水树树草草草草树树树树树树草草草草草草树树树树石石石石石石石石石石石石石石石石石石
树树树树树树树树草草树树树树树树树树树树树草树树树树树树树草草草草树树树树树树石石石石石石石石石石石石石石石石石石
树树树树树树树树草草树树树树树树树树树树树草树树树树树树树無草無無树树树树树石石石石石石石石石石石石石石石石石石石
树树树树树树树树草草树树树树树树树草草草草草树树树树树树树草草草草草草草树树石石石石石石石石石石石石石石石石石石石
树树树树树树树树草草草树树树树树树草草树树树树树树树树树树草草树树树树草草树石石石石石石石石石石石石石石石石石石石
树树树树树树树树草草草树树树树草草草草树树树树树树树树树树草树树树树树树草树树石石石石石石石石石石石石石石石石石石
树树树树树树树树草草草草草草草草草草草树树树树树草树树树树草树树树树树树草树树石石石石石石石石石石石石石石石石石石
树树树树树树树树草草草水水水水水水树树树树树树树草草草树树草树树树树树树草树树石石石石石石石石石石石石石石石石石石
树树树树树树树树草草草水水水水水水树树树树树树树树草草草草草树树树树树树草树树树石石石石石石石石石石石石石石石石石
树树树树树树树树树树树水水水水水水草草草草草草草草草草草树树树树树树树树草树树树石石石石石石石石石石石石石石石石石
树树树树树树树树树树树水水水水水水草草草草草树树树树树树树树树树树树树草草树树树树石石石石石石石石石石石石石石石石
树树树树树树树树树树树水水水水草草草树树草树树树树树树树树树树树树树草草树树树树树石石石石石石石石石石入石石石石石
树树树树树树树树树树树水水水水草草树树树草树树树树树树树树树树树树草草草树树树树树石石石石石石石石石石土土石石石石
树树树树树树树树树树草草草草草草树树树树草無草树草树树树树草草草草草草树树树树树树树石石石石石石石石石土土石石石石
树树树树树树树树树草草草草草草树树树树树草無草草草树树树树草草树树树树树树树树树树树石石石石石石石树树土土树树树树
树树树树树树树树树草草树树草草树树树树树树树树树草草草草草草树树树树树树树树树树树树石石石石石石石树树土土树树树树
树树树树树树树树草草飾树树草草草草树树树树树树树树树树树树树树树树树树树树树树树树树树石石石石石石树树花李花花花花
树树树树树树树草草草草树树树树树树树树树树树树树树树树树树树树树树树树树树树树树树树树石石石石石石树树花花李花李花
树树树树树树树草草草树树树树树树树树树树树树树树树树树树树树树树树树树树树树树树树树树树树石石石石树树花花水水水水
树树树树树树树草树树树树树树树树树树树树树树树树树树树树树树树树树树树树树树树树树树树树树石石石石树树李花水水水水
树树树树树树树草树树树树树树树树树树树树树树树树树树树树树树树树树树树树树树树树树树树树树石石石石树树花花水水水水
树树树树树树树草树树树树树树草飾草树树树树树树树树树树草草無草草草草無草草树树树树树树树树石石石石树树花李花花李花
树树树树树树树草树树树树树树草草草树树树树树草草草草草草草無無無草無無草草树树树树树树树树石石石石树树花花花花花花
树树树树树树树草草草草草草草草草草树树树树树草树树树树草草草草草草草草草草树树树树树树树树石石石石树树树树树树树树
树树树树树树树树树树树树树树树草树树树树树树草树树树树树树树树树树树树树草树树树树树树树树石石石石树树树树树树树树
树树树树树树树树树树树树树树树草树树树树树花草树树树树树树树树树树树树树草树树树树树树树树石石石石石石石石石石石石
树树树树树树树树树树树树树树树草树树树树树草花树树树树树树树树树树树树树草树树树树树树树树石石石石石石石石石石石石
树树树树树树树树树树树树树树树草树树树树树花草花草花草草草草树树树树树草草树树树树树树树树石石石石石石石石石石石石
树树树树树树树树树树树树树树树草树树树树树草花草花草花草草草树树树树树草草树树树树树树树树石石石石石石石石石石石石
树树树树树树树树树树树树树树树草树树树树树草草树树树树树树草草树树树树草草树树树树树树树树树树树树树树树树树树树树
树树树树树树树树树树树树树树树草树树树树树草草树树树树树树草草草草草草草草树树树树树树树树树树树树树树树树树树树树
树树树树树树树树树树树树树树树草树树树树树草树树树树树草草草树树树树树草草树树树树树树树树树树树树树树树树树树树树
树树树树树树树树树树树树树树树草树树树树树草树树树树树草草草树树树树树草草树树树树树树树树树树树树树树树树树树树树
树树树树树树树树树树树树树树树草草草草草草草树树树树树草草树树树树树树草草草草草树树树树树树树树树树树土土土土树树
树树树树树树树树树树树树树树树草草草草草草草树树树树树草草草草草草草草草草草草草树树树树树树树树树树树土土土土树树
树树树树树树树树树树树树树树树树树树树树树树树树树树树树树树树树树树树树树树草草树树树树树树树树树树树土土飾飾飾飾
树树树树树树树树树树树树树树树树树树树树树树树树树树树树树树树树树树石石树树草草石石树树树树石石石树树土土無门無無
树树树树树树树树树树树树树树树树树树树树树树树树树树树树石石石石石石石石石树草草草草草草草土土石石树树土土道道花花
树树树树树树树树树树树树树树树树树树树树树树树树树树树树石石石石石石石石石树草草草草草草草土土石石树树無無無道無無
树树树树树树树树树树树树树树树树树树树树树树树树树树树树石石石石石石石石石石树树树石石石石土土石石树树土土道道土土
树树树树树树树树树树树树树树树树树树树树树树树树树树树树石石石石石石石石石石石石树石石石石土土標石树树土土道道土土
树树树树树树树树树树树树树树树树树树树树树树树树树树树树石石石石石石石石石石石石石石石石石土土土土土土道道道道道道
树树树树树树树树树树树树树树树树树树树树树树树树树树树树树石石石石石石石石石石石石树树树树土土土土土土道道道道道道
树树树树树树树树树树树树树树树树树树树树树树树树树树树树树石石石石石石石石石石石树树树树树树树树树树树道道飾飾飾飾
树树树树树树树树树树树树树树树树树树树树树树树树树树树树树树石石石石石石石石石石树树树树树树树树树树树道道飾飾飾飾
树树树树树树树树树树树树树树树树树树树树树树树树树树树树石石石石石石石石石石石树树树树树树树树树树树树道道無無無無
树树树树树树树树树树树树树树树树树树树树树树树树树树石石石石石石石石石石石石石石树树树树树树树树树树树道道無無门無
树树树树树树树树树树树树树树树树树树树树树树树树树树树石石石石石石石石石石石石石石石树树树树树树树树树道道道道道道
树树树树树树树树树树树树树树树树树树树树树树树树树树树树石石石石石石石石石石石石石石石石树树树树树树树道道道道道道
树树树树树树树树树树树树树树树树树树树树树树树树树树树树树石石石石石石石石石石石石石石石石石树树树树树树树树树树树
树树树树树树树树树树树树树树树树树树树树树树树树树树树树树树石石石石石石石石石石石石石石石石石石树树树树树树树树树
树树树树树树树树树树树树树树树树树树树树树树树树树树树树树树树石石石石石石石石石石石石石石石石石石石树树树树树树树
树树树树树树树树树树树树树树树树树树树树树树树树树树树树树树树树石石石石石石石石石石石石石石石石石树树树树树树树树
树树树树树树树树树树树树树树树树树树树树树树树树树树树树树树树树树石石石石石石石石石石石石石石石石树树树树树树树树
树树树树树树树树树树树树树树树树树树树树树树树树树树树树树树树树树树石石石石石石石石石石石石石石树树树树树树树树树
树树树树树树树树树树树树树树树树树树树树树树树树树树树树树树树树树树树树树树树树树树树树树树树树树树树树树树树树树
树树树树树树树树树树树树树树树树树树树树树树树树树树树树树树树树树树树树树树树树树树树树树树树树树树树树树树树树树
树树树树树树树树树树树树树树树树树树树树树树树树树树树树树树树树树树树树树树树树树树树树树树树树树树树树树树树树树
树树树树树树树树树树树树树树树树树树树树树树树树树树树树树树树树树树树树树树树树树树树树树树树树树树树树树树树树树
树树树树树树树树树树树树树树树树树树树树树树树树树树树树树树树树树树树树树树树树树树树树树树树树树树树树树树树树树
树树树树树树树树树树树树树树树树树树树树树树树树树树树树树树树树树树树树树树树树树树树树树树树树树树树树树树树树树
树树树树树树树树树树树树树树树树树树树树树树树树树树树树树树树树树树树树树树树树树树树树树树树树树树树树树树树树树
树树树树树树树树树树树树树树树树树树树树树树树树树树树树树树树树树树树树树树树树树树树树树树树树树树树树树树树树树