树树树树树土土土土稂稂草草草草水水树树树树树石石石石石石石石石石石石石石石石石石石石石石石石石石石石石石石石石石石
树树树树树稂稂稂稂稂稂草草土土水水树树树树树树石石石石石石石石石石石石石石石石水水水水水水水石石石石石石石石石石石
树树树树树稂稂稂稂稂稂草草土土水水树树树树树树树石石石树树树树树树树树树树树树水水水水水石石石石石石石石石石石石石
树树树树树草草草草草草土土土土水水树树树树树树树石石石树树水水水水水水水水飾水水水石岩石石石石石石石石石石石石石石
树树树树树草草草草草草土土土土水水树树树树树树树树树树树树水水水水水水水飾飾飾水水石石石石石石石石石石石石石石石石
树树树树树稂稂土土草草草草稂稂水水树树树树树树树树树树树树水水畑畑畑畑飾飾飾飾门嶝嶝嶝石石石石石石石石石石石石石石
树树树树树稂稂土土草草草草稂稂水水树树树树树树树树树树树树水水畑畑畑畑無無门無無石石嶝石岩入石石岩石石石石石石石石
树树树树树稂稂土土土土土土稂稂水水水水水水水水水水水水水水水水畑畑畑畑花李土花李石石嶝石石嶝石石石石石石石石石石石
树树树树树稂稂土土土土土土稂稂水水水水水水水水水水水水水水水飾飾飾飾土土土土石石石石嶝嶝嶝嶝石石石石石石石石石石石
水水水水水水水水橋橋水水水水水水水树树树树树草草草草草草草草無门無無土飾飾飾飾石石石石石石石石石石石石石石石石石石
水水水水水水水水橋橋水水水水水水水树树草草草草树树树树树树草草土土土土飾飾飾飾石石石岩石岩石石石石石石石石石石石石
水水水水水树树树草草树树树树树树树树树树树草树树树树树树树草草草草树土無無無無石飾飾飾飾石石石石石石石石石石石石石
树树树树水树树树草草树树树树树树树树树树树草树树树水水树树無草無無树土無门館無石無门学無石石石石石石石石石石石石石
树树树树水树树树草草树树树树树树树草草草草草树树树水树树树草草草草草土土土土土土土土石石石石石石石石石石石石石石石
树树树树水树树树草草草树树树树树树草草树树树树水水水树树树草草树树树树草草树石石石石石石石石石石石石石石石石石石石
树树树树水树树树草草草树树树树草草草草树树水水水树树树树树草树树树树树树草树树石石石石石石石石石石石石石石石石石石
树树树树水树树树草草草草草草草草草草草树树水树树草树树树树草树树树树树树草树树石石石石石石石石石石石石石石石石石石
树树树树水水树树草草草水水水水水水水水水水水树树草草草树树草树树树树树树草树树石石石石石石石石石石石石石石石石石石
树树树树树水树树草草草水水水水水水树树树树树树树树草草草草草树树树树树树草树树树石石石石石石石石石石石石石石石石石
树树树树树水水水树树树水水水水水水草草草草草草草草草草草树树树树树树树树草树树树石石石石石石石石石石石石石石石石石
树树树树树树树水水水水水水水水水水草草草草草树树树树树树树树树树树树树草草树树树树石石石石石石石石石石石石石石石石
树树树树树树树树树树树水水水水草草草树树草树树树树树树树树树树树树树草草树树树树树石石石石石石石石石石入石石石石石
树树树树树树树树树树树水水水水草草树树树草树树树树树树树树树树树树草草草树树树树树石石石石石石石石石石土土石石石石
树树树树树树树树树树草草草草草草树树树树草稂草树草树树树树草草草草草草树树树树树树树石石石石石石石石石土土石石石石
树树树树树树树树树草草草草草草树树树树树草稂草草草树树树树草草树树树树树树树树树树树石石石石石石石树树土土树树树树
树树树树树树树树树草草树树草草树树树树树树树草树草草草草草草树树树树树树树树树树树树石石石石石石石树树土土树树树树
树树树树树树树树草草花树树草草草草树树树树树草树树树树草树树树树树树树树树树树树树树树石石石石石石树树花李花花花花
树树树树树树树草草草草树树树树树树树草草草草草树树树树草树石石石石石石树树树树树树树树石石石石石石树树花花李花李花
树树树树树树树草草草树树树树树树树树草树树树树树树树草草树石草草草草石水水水水水水水水水水石石石石树树花花水水水水
树树树树树树树草树树树树树树树树树树草草草草草草草草草树树石草草水水水水水水水水水水水水水石石石石树树李花水华水水
树树树树树树树草树树树树树树树树树树树树树树树树树树树树树石草草草草石树树树树树树树树水水石石石石树树花花水水水水
树树树树树树树草树树树树树树草花草树树树树树树树树树树草草石草草草草石草草树树树树树树水水石石石石树树花李花花李花
树树树树树树树草树树树树树树草草草草草树树树草草草草草草草石石石草石石草草树树树树树树水水石石石石树树花花花花花花
树树树树树树树草草草草草草草草草草树草树树树草树树树树草草草草草草草草草草树树树树树树水水石石石石树树树树树树树树
树树树树树树树树树树树树树树树树树树草树树树草树树树树树树树树树树树树树草树树树树树树水水石石石石树树树树树树树树
树树树树树树树树树树树草草草树树树树草树树花草树树树树树树树树树树树树树草树树树树树树水水石石石石石石石石石石石石
树树树树树树树树树树草草树草树树树树草树树草花树树树树树树树树树树树树树草树树树树树树水水石石石石石石石石石石石石
树树树树树树树树树草草树树草草草树树草树树花草花草花草草草草树树树树树草草树树树树树树水水石石石石石石石石石石石石
树树树树树树树树树草树树树树树草树树草树树草花草花草花草草草树树树树树草草树树树树树树水水石石石石石石石石石石石石
树树树树树树树树树草树树树树树草树树草树树草草树树树树树树草草树树树树草草树树树树树树水水水水树树树树树树树树树树
树树树树树树树树树草树树树树树草树树草树树草草树树树树树树草草草草草草草草树树树树树树水水水水树树树树树树树树树树
树树树树树树树树树草树树树树树草草草草树树草树树树树树草草草树树树树树草草树树树树树树树树水水树树树树树树树树树树
树树树树树树树树树草草树树树树草树树树树树草树树树树树草草草树树树树树草草树树树树树树树树水水树树树土花土花土花土
树树树树树树树树树树草草草草草草草草草草草草树树树树树草草树树树树树树草草草草草树树树树树水水树树树花飾飾飾飾飾飾
树树树树树树树树树树树树树树树草草草草草草草树树树树树草草草草草草草草草草草草草树树树树树水水水水水土飾飾飾飾飾飾
树树树树树树树树树树树树树树树树树树树树树树树树树树树树树树树树树树树树树树草草树树树树树水水水水水花無無無無無無
树树树树树树树树树树树树树树树稂稂稂稂稂树树树树树树树树树树树树树树石石树树草草石石树树树树树树水水土無無门学無無
树树树树树树树树树树树树树稂稂稂稂無稂稂稂树树树树树树树石石石石石石石石石树草草草草草草草土土树水水花土花土花土花
树树树树树树树树树树树树水水水稂無無無稂稂稂稂树树树树石石石石石石石石石石树草草草草草草草土土树水水水水水橋橋水水
树树树树树树树树树树树树水仏水無無门無無稂稂稂稂树树树石石石石石石石石石石石树树树石石石石土土树水水水水水橋橋水水
树树树树树树树树树树树树水草水稂稂草稂水水稂稂稂树树石石石石石石石石石石石石石石树石石石石土土树树土土道道道道道道
树树树树树树树树树树树树稂草稂稂稂草稂水水稂稂稂树树石入石石石石石石石石石石石石石石石石石土土土土土土道道道道道道
树树树树树树树树树树树树树草草草草草稂稂稂稂稂稂稂稂稂稂稂石石石石石石石石石石石石树树树树土土土土土土道道道道道道
树树树树树树树树树树树树树稂稂水水草稂稂無稂稂稂稂稂稂稂稂石石石石石石石石石石石树树树树树稂稂树树树树道道飾飾飾飾
树树树树树树树树树树树树树稂稂水水草稂無無無稂树树树树树稂稂石石石石石石石石石石树树树树树稂稂树树树树道道飾飾飾飾
树树树树树树树树树树树树树树稂稂稂草無無门無無树树树树树石石石石石石石石石入石稂稂稂稂稂稂稂稂树树树树道道無無無無
树树树树树树树树树树树树树树树稂稂草草草草树树树树树石石石石石石石石石石石稂稂稂稂稂稂稂稂稂稂树树树树道道無無门競
树树树树树树树树树树树树树树树树树树树树树树树树树树树石石石石石石石石石石石石石石石稂稂稂稂稂树树树树道道道道道道
树树树树树树树树树树树树树树树树树树树树树树树树树树树树石石石石石石石石石石石石石石石石树树树树树树树道道道道道道
树树树树树树树树树树树树树树树树树树树树树树树树树树树树树石石石石石石石石石石石石石石石石石树树树树树树树树树树树
树树树树树树树树树树树树树树树树树树树树树树树树树树树树树树石石石石石石石石石石石石石石石石石石树树树树树树树树树
树树树树树树树树树树树树树树树树树树树树树树树树树树树树树树树石石石石石石石石石石石石石石石石石石石树树树树树树树
树树树树树树树树树树树树树树树树树树树树树树树树树树树树树树树树石石石石石石石石石石石石石石石石石树树树树树树树树
树树树树树树树树树树树树树树树树树树树树树树树树树树树树树树树树树石石石石石石石石石石石石石石石石树树树树树树树树
树树树树树树树树树树树树树树树树树树树树树树树树树树树树树树树树树树石石石石石石石石石石石石石石石石树树树树树树树
树树树树树树树树树树树树树树树树树树树树树树树树树树树树树树树树树树树树树树树树树树树石石石石石石石石树树树树树树
树树树树树树树树树树树树树树树树树树树树树树树树树树树树树树树树树树树树树树树树树树树树树树石石石石石石树树树树树
树树树树树树树树树树树树树树树树树树树树树树树树树树树树树树树树树树树树树树树树树树树树树水水石石石石石石树树树树
树树树树树树树树树树树树树树树树树树树树树树树树树树树树树树树树树树树树树树树树树树树树树水水水石石石石石石树树树
树树树树树树树树树树树树树树树树树树树树树树树树树树树树树树树树树树树树树树树树树树树树树水水水石石石石石石石树树
树树树树树树树树树树树树树树树树树树树树树树树树树树树树树树树树树树树树树树树树树树树树树水水岩石石石石石石石树树
树树树树树树树树树树树树树树树树树树树树树树树树树树树树树树树树树树树树树水水水树树树树水水水石石石石石石石石石石
树树树树树树树树树树树树树树水水水水水水水水水水水水水水水水水水水水水水水水岩水水水水水水岩水石石石石石石石石石石