树树树树树土土土土稂稂草草草草水水树树树树树树树树树树树┣树树┣穴穴穴穴穴穴┌┻┻┻┻┻┻┻┓┣┣┣┣穴穴┫┫┫穴
树树树树树稂稂稂稂稂稂草草土土水水树树树树树树树树树树树┣树树┗┻┻┻┻┻┻┛水水水水水水水┣┣┣┣┣穴穴┫┫┫┌
树树树树树稂稂稂稂稂稂草草土土水水树树树树树树树树树树树┣树树树树树树树树树树水水水水水┏┳┳┣┣┣┣穴穴┫┫┫┛
树树树树树草草草草草草土土土土水水树树树树树树树树树树树┣水水水水水水水水飾水水水┏┳┳┳┏┳┳┣┣┣穴穴┲┲┳┳
树树树树树草草草草草草土土土土水水树树树树树树树树树树树┣水水水水水水水飾飾飾水水┗┻┐┏┳穴穴┣┣┣穴穴══穴穴
树树树树树稂稂土土草草草草稂稂水水树树树树树树树树树树树┣水水畑畑畑畑飾飾飾飾门穴穴穴┣┗┻┻┐┣┣┣穴穴┣┗┻┻
树树树树树稂稂土土草草草草稂稂水水树树树树树树树树树树树┣水水畑畑畑畑無無门無無┏┓穴┣┌入┐┣┣┣┣穴穴┗┻┻┻
树树树树树稂稂土土土土土土稂稂水水水水水水水水水水水水水水水水畑畑畑畑花李土花李┣┫穴┗┛穴┣┣┣┣┣穴┌┻┻┻┻
树树树树树稂稂土土土土土土稂稂水水水水水水水水水水水水水水水飾飾飾飾土土土土土┏┳┫穴穴穴穴┣┣┣┣┣穴┫┌┻┻┻
水水水水水水水水圯圯水水水水水水水树树树树树草草草草草草═草無门無無土飾飾飾飾┣穴┳┳┳┳┳┳┣┣┣┣穴┫┫┌┻┻
水水水水水水水水圯圯水水水水水水水树树草草草草树树树树树┣草草土土土土飾飾飾飾┗┻┻┻┻┐┏┳┳┣┣┣穴┫┫┫┌┻
水水水水水树树树草草树树树树树树树树树树树草树树树树树树┣草草草草树土無無無無土飾飾飾飾┣┣穴穴┣┣┣穴┫┫┫┫┌
树树树树水树树树草草树树树树树树树树树树树草树树树水水树┣無草無無树土無门館無土無门学無┣┣┏┲┲┲┳┓┫┫┫┫┫
树树树树水树树树草草树树树树树树树草草草草草树树树水树树┣草草草草草土土土土土土土土树树┣┣┣┣┣┗入┛┫┫┫┫┫
树树树树水树树树草草草树树树树树树草草树树树树水水水树树┣草草树树树树草草树树┏┲┳┳┳┳┳┣┣┣穴穴穴┫┫┫┫┫
树树树树水树树树草草草树树树树草草草草树树水水水树树树树┣草树树树树树树草树树┣┣穴穴穴穴穴┣┣┗║┻┻┛┫┫┫┫
树树树树水树树树草草草草草草草草草草草树树水树树草树树树┣草树树树树树树草树树┣┗┻┻┻┻┐┣┣穴穴穴穴穴┫┫┫┫
树树树树水水树树草草草水水水水水水水水水水水树树草草草树┣草树树树树树树草树树┗┻┻┐穴穴┣┣┗┻┻┻┻║┛┫┫┫
树树树树树水树树草草草水水水水水水树树树树树树树树草草草═草树树树树树树草树树树树┣┣穴穴┣┣穴穴穴穴穴穴穴┫┫┫
树树树树树水水水树树树水水水水水水草草草草草草草草草草草┗┻┻┻┻┻┻┻║┻┻┻┻┐┣穴穴┣┗┻║┻┻┻┻┻┛┫┳
树树树树树树树水水水水水水水水水水草草草草草树树树树树树树树树树树树树草草树树树树┣┣穴穴┗┻┐穴┌┻┻┻┻┻┛穴
树树树树树树树树树树树水水水水草草草树树草树树树树树树树树树树树树树草草树树树树树┣┗┐┏┳┓┗║┛┌入┻┐穴穴穴
树树树树树树树树树树树水水水水草草树树树草树树树树树树树树树树树树草草草树树树树树┗┐┣┣穴┫穴穴穴┫土土┣穴穴穴
树树树树树树树树树树草草草草草草树树树树草稂草树草树树树树草草草草草草树树树树树树树┣┣┗┻┛穴┌║┛土土┗┻┻┻
树树树树树树树树树草草草草草草树树树树树草稂草草草树树树树草草树树树树树树树树树树树┣┗┐穴穴穴┫土树土土树树树树
树树树树树树树树树草草树树草草树树树树树树树草树草草草草草草树树树树树树树树树树树树┗┐┗┐穴穴┫土树土土树树树树
树树树树树树树树草草花树树草草草草树树树树树草树树树树草树树树树树树树树树树树树树树树┗┐┗┐穴┫土树花李花花花花
树树树树树树树草草草草树树树树树树树草草草草草树树草草草树树树树┌┻┻┻┻┻┻┻┻┻┻┻┻┐┣穴┫土树花花李花李花
树树树树树树树草草草树树树树树树树树草树树树树树树草树树树树树树┫水水水水水水水水水水水水┣┣穴┫土树花花水水水水
树树树树树树树草树树树树树树树树树树草草草草草草草草树树树树树树┫水水水水水水水水水水水水┣┗┐┫土树李花水华水水
树树树树树树树草树树树树树树树树树树树树树树树树树树树树树树树树┳┳┳┳┳┳┳┳┳┳┓水水┗┐┣┫土树花花水水水水
树树树树树树树草树树树树树树草花草树树树树树树树树树树土土土土土土土土土土树树树树树┫水水水┣┣┫土树花李花花李花
树树树树树树树草树树树树树树草草草草草树树树草草草草草土土土土土土土土土土树树树树树┫水水水┣┣┫土树花花花花花花
树树树树树树树草草草草草草草草草草树草树树树草树树树树土土土土土土土土土土树树树树树┳┓水水┣┣┫土树树树树树树树
树树树树树树树树树树树树树树树树树树草树树树草树树树树树树树树树树树树草草树树树树树树┫水水┣┣┫土土土土土土土土
树树树树树树树树树树树草草草树树树树草树树花草树树树树树树树树树树树树草草树树树树树树┫水水┣┣┲┳┳┳┳┳┳┳┳
树树树树树树树树树树草草树草树树树树草树树草花树树树树树树树树树树树树草草树树树树树┌┛水水┣┣┗┻┻┻┻┻┻┻┻
树树树树树树树树树草草树树草草草树树草树树花草花草花草草草草树树树树树草草树树树树树┫水水水┣┗┻┻┻┻┻┻┻┻┻
树树树树树树树树树草树树树树树草树树草树树草花草花草花草草草树树树树树草草树树树树树┫水水水┗┐穴穴穴┌┻┻┻┻┻
树树树树树树树树树草树树树树树草树树草树树草草树树树树树树草草树树树树草草树树树树树┫水水树树┣穴穴穴┫树树树树树
树树树树树树树树树草树树树树树草树树草树树草草树树树树树树草草草草草草草草树树树树树┫水水树树┗║┻┻┛树树树树树
树树树树树树树树树草树树树树树草草草草树树草树树树树树草草草树树树树树草草树树树树树┫水水水水土土树树树树树树树树
树树树树树树树树树草草树树树树草树树树树树草树树树树树草草草树树树树树草草树树树树树┫水水水水土树树土花土花土花土
树树树树树树树树树树草草草草草草草草草草草草树树树树树草草树树树树树树草草草草草树树┳┳┓水水土土土花飾飾飾飾飾飾
树树树树树树树树树树树树树树树草草草草草草草树树树树树草草草草草草草草草草草草草树树树树┫水水水水水土飾飾飾飾飾飾
树树树树树树树树树树树树树树树树树树树树树树树树树树树树树树树树树树树树树树草草树树树树┫水水水水水花無無無無無無
树树树树树树树树树树树树树树树稂稂稂稂稂树树树树树树树树树树树树树树┏┓树树草草树树树树┳┳┳┓水水土無無门学無無
树树树树树树树树树树树树树稂稂稂稂無稂稂稂树树树树树树树┏┲┳┳┳┳┳┱┓树草草草草草草草土土┫水水花土花土花土花
树树树树树树树树树树树树水水水稂無無無稂稂稂稂树树树树┏┲┳穴穴穴穴穴┫┫树草草草草草草草土土┫水水水水水圯水水水
树树树树树树树树树树树树水仏水無無门無無稂稂稂稂树树树┣┣穴穴穴穴穴穴┳┱┓树树树树树树树土土┫水水水水水圯水水水
树树树树树树树树树树树树水草水稂稂草稂水水稂稂稂树树┏┳┗┻┐穴穴穴穴穴┳┳┱┓树树树树树土土┫树土土道道道道道道
树树树树树树树树树树树树稂草稂稂稂草稂水水稂稂稂树树┗入┻┐┣穴穴穴穴穴穴穴┫┳┓树树树树土土─土土土道道道道道道
树树树树树树树树树树树树树草草草草草稂稂稂稂稂稂稂稂稂稂稂┣┗┐穴穴穴穴穴穴┫┌┛树树树树土土─土土土道道道道道道
树树树树树树树树树树树树树稂稂水水草稂稂無稂稂稂稂稂稂稂稂┗┐┣穴穴穴穴穴┌┛┫树树树树树稂稂┫树树树道道飾飾飾飾
树树树树树树树树树树树树树稂稂水水草稂無無無稂树树树树树稂稂┣┣穴穴穴┌┻┛┌┛稂稂草树稂稂稂┫树树树道道飾飾飾飾
树树树树树树树树树树树树树树稂稂稂草無無门無無树树树树树┏┲┳┳穴穴穴┫┌入┛稂草树稂稂稂稂稂┫树树树道道無無無無
树树树树树树树树树树树树树树树稂稂草草草草树树树树树┏┳┳┣穴穴穴穴穴┫┫稂稂草草稂草草稂草树┫树树树道道無無门競
树树树树树树树树树树树树树树树树树树树树树树树树树树┗┻┐┗┐穴穴穴穴┳┳┳┳┳┱┓树稂树稂稂┫树树树道道道道道道
树树树树树树树树树树树树树树树树树树树树树树树树树树树树┗┐┗┐穴穴穴穴穴穴穴穴┳┳┱┓树树草┫树树树道道道道道道
树树树树树树树树树树树树树树树树树树树树树树树树树树树树树┗┐┗┐穴穴穴穴穴穴穴穴穴┳┳┱┓树┫树树树树树树树树树
树树树树树树树树树树树树树树树树树树树树树树树树树树树树树树┗┐┣穴穴穴穴穴穴穴穴穴穴穴┳┱┓┫树树树树树树树树树
树树树树树树树树树树树树树树树树树树树树树树树树树树树树树树树┣┣穴穴穴穴穴穴穴穴穴穴穴穴┫┫┳┳┳┓树树树树树树
树树树树树树树树树树树树树树树树树树树树树树树树树树树树树树树┣┣穴穴穴穴穴穴┏┲┲┱┱┓┫┳┳┳┓┫树树树树树树
树树树树树树树树树树树树树树树树树树树树树树树树树树树树树树树┣┣穴穴穴穴穴穴┣┣┣┫┫┫┫穴穴穴┫┫树树树树树树
树树树树树树树树树树树树树树树树树树树树树树树树树树树树树树树┣┣穴穴穴穴穴穴┣┣┣┫┫┫┫穴穴穴┫┳┳┳┳┓树树
树树树树树树树树树树树树树树树树树树树树树树树树树树树树树树树┣┣穴穴穴穴穴穴┣┣┣┫┫┫┳┳┳┳┳┳┳┳┓┫树树
树树树树树树树树树树树树树树树树树树树树树树树树树树树树树树树┣┣穴穴穴穴穴穴┣┣┣┫┫┫穴穴穴穴穴穴穴穴┫┫树树
树树树树树树树树树树树树树树树树树树树树树树树树树树树树树树树┣┣穴穴穴穴穴穴┣┣┣┫┫┫水水穴穴穴穴穴穴┫┫树树
树树树树树树树树树树树树树树树树树树树树树树树树树树树树树树树┣┣水水水水水水┣┣┣┫┫┫水水穴穴穴穴穴穴┫┫树树
树树树树树树树树树树树树树树树树树树树树树树树树树树树树树树树┣┣水水水水水水┣┣┗┛┫┫水水穴穴穴穴穴穴┫┫树树
树树树树树树树树树树树树树树树树树树树树树树树树树树树树树树树┣┗滝滝┻┐水水┣┗┻┻┛┫水水穴穴穴穴穴穴┫┫树树
树树树树树树树树树树树树树树树树树树树树树树树树树树树树树树树┗┻滝滝┐┣水水┗┻┻┻┻┛水水穴穴穴穴穴穴┳┳┳┳
树树树树树树树树树树树树树树水水水水水水水水水水水水水水水水水水水水水┣┣水水水水水水水水水水穴穴穴┏┳┳┳┳┳┳
