無無無無無無無無無無無無無無無無無無無無無無無
無無無無無無無無無無無無無無無無無無無無無無無
無無無無無無無無無無無無無石石無無無無無無無無
無無無無無無無石石石石石石石石石無無無無無無無
無無無無無無石石石岩穴穴湿湿湿石無無無無無無無
無無無無無無石穴穴穴穴湿湿湿湿石石無無無石石石
無無無無無石穴穴岩穴穴穴穴穴湿湿石石石無石石石
無無無無無石入石石穴岩石穴穴穴湿湿湿石石石石石
無無無無無無無無石穴穴石岩穴穴湿湿岩石石無無無
無無無無無無無無石石穴石穴穴穴穴穴石石無無無無
無無無無無無無無無石穴石穴石石岩穴石石無無無無
無無無無無無無石石岩穴岩穴石石石入石無無無無無
無無無無無石石石石穴穴穴穴穴穴石無無無無無無無
無無無無無無石石岩穴岩穴石石穴石石石石石石無無
無無無無無無無石石穴穴穴岩穴穴石石岩石石石石石
無無無無無無無無石石石穴穴穴石石石石石石岩石石
無無無無無無無無無石石石石石石石石石石石石石石