無無無無無無無無無無無無無無無無無無無無無無無無無無無
無無無無無無無無無無無無無無無無無無無無無無無無無無無
無無無無無無無無無無無無無無無無無無無無無無無無無無無
無無無無無無無無無無無無無無無無無無無無無無無無無無無
無無無無無無無無無無無無無無無無無無無無無無無無無無無
無無無無無無無無無無無無無無無無無無無無無無無無無無無
無無無無無無無無無無無無無無無無無無無無無無無無無無無
無無無無無無無無無無無無無無無無無無無無無無無無無無無
無無無無無無無無無無無無無無無無無無無無無無無無無無無
無無無無無無無無無無無無無無無無無無無無無無無無無無無
無無無無無無無無無無無無無無無無無無無無無無無無無無無
無無無無無無無無無無無無無無無無無無無無無無無無無無無
無無無無無無無無無無無無無無無無無無無無無無無無無無無
無無無無無無無無無無無無無無無無無無無無無無無無無無無
無無無無無無無無無無無無無無無無無無無無無無無無無無無
無無無無無無無無無無無無無無無無無無無無無無無無無無無
無無無無無無無無無無無無無無無無無無無無無無無無無無無
無無無無無無無無無無無無無無無無無無無無無無無無無無無
無無無無無無無無無無無無無無無無無無無無無無無無無無無
無無無無無無無無無無土土土仏土土土無無無無無無無無無無
無無無無無無無無無無土土土土土土土無無無無無無無無無無
無無無無無無無無無無寺寺寺寺寺寺寺寺门無無無無無無無無
無無無無無無無無無無寺寺寺寺寺寺寺無無無無無無無無無無
無無無無無無無無無無寺寺寺寺寺寺寺無無無無無無無無無無
無無無無無無無無無無寺寺寺寺寺寺寺無無無無無無無無無無
無無無無無無無無無無無無無门無無無無無無無無無無無無無
無無無無無無無無無無無無無無無無無無無無無無無無無無無