┏┳┳┳┳┓┌┻┻┻┻┻┻入┻┻┻┻┻┻┻┐
┣湿湿湿湿┫┫穴┏穴穴穴穴穴┏┳┳┳┳┓┓┣
┣湿穴穴穴┫┫穴═穴穴穴穴穴┗┻┻┻┻┛┫┣
┣┏┓穴穴┫┫穴┣┏┳┳┓穴穴穴穴穴穴穴┫┣
┣┗┛穴穴┫┫穴┣┣穴穴┫穴穴穴穴穴穴穴┫┣
┗┻┻┻║┛┫穴┣┗┻┻┛穴穴穴穴穴穴穴┫┣
┌┻┻┻║┻┛穴┗┻┻┻┻┻║┻┐穴穴穴┫┣
┫穴穴穴穴穴穴穴穴湿湿湿湿穴穴穴┣穴穴穴┫┣
┫穴門穴穴穴穴穴穴湿湿湿湿穴穴穴┣岩穴岩┫┣
┫穴穴穴穴穴穴岩穴湿湿湿湿穴穴穴┣穴穴穴┫┣
┫穴穴穴穴穴穴穴穴┏┳┳┳┓穴穴┣穴穴穴┫┣
┫穴穴岩┌┻║┻┐┣穴穴穴┫穴穴┣岩穴穴┫┣
┫穴穴穴┫┌║┐┣┗┻║┻┛穴穴┣穴穴穴┫┣
┫穴穴穴┫┫穴┣┣穴穴穴穴┏┓穴┣穴穴穴┫┣
┫湿湿湿┫┫穴┣┣穴┏┓穴┗┛穴┣岩穴穴┫┣
┫湿湿湿┫┫岩┣┣穴┗┛穴穴穴穴┗┻┻┻┛┣
┳┳┳┳┳┳┳┳┳u┳┳┳┳┳┳┳┳┳┳┳┏