┻┻┐┣穴穴穴穴┫穴┫┫穴穴岩穴穴穴┫┫草草草草土土树树树树树树树树树树树树树树树树树树树树树树树树树树树树树树树树树树树树树树树水水树树树树树树树树树树树树树树树树树树树
┻┐┣┣穴穴穴穴┫穴──穴穴穴穴岩穴┫┫草草土土土土树树树树树树树树树树树树树树树树树树树树树树树树树树树树树树树树树树树树树树树水水树树树树树树树树树树树树树树树树树树树
┐┣┣┣穴穴穴穴┫穴┫┫穴岩穴穴穴穴┫┫树树土土土土树树树树树树树树树树树树树树树树树树树树树树树树树树树树树树树树树树树树树树树水水树树树树树树树树树树树树树树树树树树树
┣┣┣┗┻┻┻┻┛穴┫┫穴穴穴穴岩穴┫┫树树土土草草草草树树树树树树树树树树树树树树树树树树树树树树树树树树树树树树树树树树树树树水水树树树树树树树树树树树树树树树树树树树
┣┣┗┻┻┻┻┻┻┻┛┫穴穴岩穴穴穴┫┫树树土土草草草草树树树树树树树树树树树树树树树树树树树树树树树树树树树树树树树树树树树树树水水树树树树树树树树树树树树树树树树树树树
┣┣┌┻┻┻┻┻┻┻┻┛穴穴穴穴穴┌┛┫树树土土草草草草树树树树树树树树树树树树树树树树树树树树树树树树树树树树树树树树树树树树树水水树树树树树树树树树树树树树树树树树树树
┣┗┛┌┻┻┻┻┻┻┻┻┻┻┻┐穴┫┌┛草草土土草草草草树树树树树树树树树树树树树树树树树树树树树树树树树树树树树树树树树树树树树水水树树树树树树树树树树树树树树树树树树树
┣┌┻┛┌┻┻┻┻┻┻┻┻┻┐┗┻┛┫树草草土土草草树树树树树树树树树树树树树树树树树树树树树树树树树树树树树树树树树树树树树树树水水树树树树树树树树树树树树树树树树树树树
┗┛┌┻┛树树树树树树树树树┗┻┐┌┛树草草草草草草树树树树树树树树树树树树树树树树树树树树树树树树树树树树树树树树树树树树树水水水水树树树树树树树树树树树树树树树树树树树
水穴┫树树树树树树树树树树树树树┗┛树树草草草草草草树树树树树树树树树树树树树树树树树树树树树树树树树树树树树树树树树树树树树水水水水树树树树树树树树树树树树树树树树树树树
滝║┛树树树树土树树树树树树树树树树草草草草土土草草树树树树树树稂稂稂稂稂稂稂稂树树树树树树树树树树树树树树畑畑畑畑畑飾飾飾飾水水树树树树树树树树树树树树树树树树树树树树树
水土土树树树树土土树树树树树树树树树草草草草土土草草树树树树树树稂稂稂稂稂稂稂草草草树树树树树树树树树树树树畑畑畑畑畑無门無無水水树树树树树树树树树树树树树树树树树树树树树
水土土土树树树土土树树树树树草草土土土草草土土土树树树树树树树树稂稂稂稂稂稂稂草仏草稂稂稂稂稂树树树树树树树畑畑畑畑畑土土土土水水树树树树树树树树树树树树树树树树树树树树树
水水土土土土土土花树树树树树草草土土土草草土土土树树树树树树树树稂稂稂無稂稂稂草草草稂稂稂稂稂稂树树树树树树畑畑畑畑畑土土土土水水树树树树树树树树树树树树树树树树树树树树树
水水土土土土土花花树树树树树土土土土草草草草树树树树树树树树树树稂稂無無無稂稂稂稂稂稂稂稂稂稂稂稂树树树树树畑畑畑畑畑水水水水水水树树树树树树树树树树树树树树树树树树树树树
水水水土土土土树树树树树树树土土土土草草草草树树树树树树树树树树稂無無门無無稂稂稂稂稂稂稂稂稂稂稂树树树树树畑畑畑畑畑水水水水水水树树树树树树树树树树树树树树树树树树树树树
┓水水水飾门飾飾树树飾飾飾飾道道树树树树树树树树树树树树树树树树稂稂稂稂稂稂稂稂稂稂稂稂稂無稂稂稂树树树树树畑畑畑畑畑水水树树树树树树树树树树树树树树树树树树树树树树树树树
┳┓水水飾飾飾飾树树無门無無道道树树树树树树树树树树树树树树树树稂稂稂稂稂稂稂稂稂稂稂稂無無無稂稂树树树树树畑畑畑畑畑水水树树树树树树树树树树树树树树树树树树树树树树树树树
┌┛水水無無無無道道道道道道道道飾飾飾飾树┏┲┱┓树树树树树树树稂稂稂稂稂稂稂稂稂稂稂無無门無無稂树树树树树畑畑畑畑畑水水树树树树树树树树树树树树树树树树树树树树树树树树树
┫水水水無门無無道道道道道道道道飾飾飾飾树┣┗┛┫树树树树树树树稂稂稂稂稂稂稂稂稂稂稂稂稂稂稂稂稂树树树树树树树水水圯水水树树树树树树树树树树树树树树树树树树树树树树树树树
┫水水水道道道道道道土土土李道道無無無無树┗入┻┛树树树树树树树稂稂稂稂稂稂稂稂稂稂稂稂稂稂稂稂树树树树树树树树水水圯水水树树树树树树树树树树树树树树树树树树树树树树树树树
┫水水土道道道道道道李土土土道道無门無無树树土树树树树树树树树树树树树树稂稂稂無稂稂稂树树树树树树草草草草草草草橋橋畑畑畑树树树树树树树树树树树树树树树树树树树树树树树树树
─橋橋道道道土土道道道道道道道道道道道道树树土树树树树树树树树树树树树树稂稂無無無稂稂树树树树树树草草草草草草草水水畑畑畑树树树树树树树树树树树树树树树树树树树树树树树树树
┫水水土土土土土道道道道道道道道道道道道土土土树树树树树树树树树树树树树稂無無门無無稂树树树树树树草草树树树草草水水畑畑畑树树树树树树树树树树树树树树树树树树树树树树树树树
┫水水树树树土土土土土土树树土土道道飾飾飾飾飾飾树树树树树树树树树树树树稂稂稂稂稂稂稂树树树树树树草草树树树草草水水畑畑畑树树树树树树树树树树树树树树树树树树树树树树树树树
┛水水树树树土土土土土土树树土土道道飾飾飾飾飾飾树树树树树树树树树树树树树稂稂稂稂稂稂树树树树树树草草树树树草草水水畑畑畑树树树树树树树树树树树树树树树树树树树树树树树树树
水水水土土土土土树树树树树树树树道道無無無無無無土土土土土土土草草树树树树稂稂稂稂稂稂树树树树草草草草草草草草草水水畑畑畑树树树树树树树树树树树树树树树树树树树树树树树树树
水水水土土土土土树树树树树树树树道道無门無無门無土土土土土土土草草树树树树树树树稂稂树树树树树草草草草草草草草草水水畑畑畑树树树树树树树树树树树树树树树树树树树树树树树树树
水花土土土树树树树树树树飾飾飾飾道道道道树树道道道道道道道土土草草树树树树树树树稂稂树树树树树草草水水水水水水水水水畑畑畑树树树树树树树树树树树树树树树树树树树树树树树树树
水土花土土树树树树树树树飾飾飾飾道道道道树树道道道道道道道土土草草树树树树树树树稂稂树树树树树草草水水水水水水水水水畑畑畑树树树树树树树树树树树树树树树树树树树树树树树树树
水水水土土土土土土土土土無無無無树树树树树树树树树树树道道土土土土土土土树树草草草草草草草树树草草水水飾飾飾飾畑畑畑畑畑畑树树树树树树树树树树树树树树树树树树树树树树树树树
水水水土土土土土土土土土無门無無树树树树树树树树树树树道道土土土土土土土树树草草草草草草草树树草草水水無门無無畑畑畑畑畑畑树树树树树树树树树树树树树树树树树树树树树树树树树
┓水水┏┳┳┳┳┳┓土土土土土花树树树树树树树树树土土道道道道道道道土土树树道道道道道道道树树道道橋橋道道道道畑畑畑畑畑畑树树树树树树树树树树树树树树树树树树树树树树树树树
┫水水┣┏┳┳┳┓┫土土土土花土花树土树树树树树树土土道道道道道道道土土树树道道道道道道道树树道道橋橋道道道道畑畑畑畑畑畑树树树树树树树树树树树树树树树树树树树树树树树树树
┫水水┣┣┏┳┓┫┫树树树树树花土土土树树树树草草土土草草草草草道道土土树树道道树树树道道树树道道水水树树道道树树树树树树树树树树树树树树树树树树树树树树树树树树树树树树树
┫水水┣┣┣穴┫┫┫树树树树树树树树树树树树树草草土土草草草草草道道土土树树道道稂稂稂道道树树道道水水树树道道树树树树树树树树树树树树树树树树树树树树树树树树树树树树树树树
┫水水┣┣┣穴┫┫┳┓树树树树树树树树树树树树草草土土树水水水水圯圯水水水水圯圯水水水圯圯水水圯圯水水树树道道树树树树树树树树树树树树树树树树树树树树树树树树树树树树树树树
┫水水┣┣┣穴┫┳┓┫树树树树树树树树树树树树草草土土树水水水水圯圯水水水水圯圯水水水圯圯水水圯圯水水树树道道树树树树树树树树树树树树树树树树树树树树树树树树树树树树树树树
┫水水┣┣┣穴┫穴┫┫树树树┏┳┳┓稂稂草草草草草土土树水水树树道道稂稂稂稂道道树树树道道道道道道树树树树土土土土树树树树树树树树树树树树树树树树树树树树树树树树树树树树树
┫水水┣┣┣穴┫穴┫┫树树树┗┻┻┛稂稂草草草草草土土树水水树树道道树树树树道道树树树道道道道道道树树树树土土土土树树树树树树树树树树树树树树树树树树树树树树树树树树树树树
─橋橋═══穴─穴┫┫土土土土土土土稂稂稂稂稂土土土土树水水树树道道道道道道道道树树树树树树树树树树树树树草草土土树树树树树树树树树树树树树树树树树树树树树树树树树树树树树
┫水水┣┣┣穴┫穴──土土土土土土土稂稂稂稂稂土土土土树水水树树道道道道道道道道树树树树树树树树树树树树树草草土土树树树树树树树树树树树树树树树树树树树树树树树树树树树树树
┫水水┣┣┣穴┫穴┫┫树┏┓草草土土稂稂土土土土土水水水水水树树树树树树树树树树树树树树树树树树树树树树树草草土土树树树树树树树树树树树树树树树树树树树树树树树树树树树树树
┛水水┣┣┣穴┫┌┛┫树┗┛草草土土稂稂土土土土土水水水水水树树树树树树树树树树树树树树树树树树树树树树树草草土土树树树树树树树树树树土土土土土土土土花土树树树树树树树树树
水水水┣┣┣穴┫┫穴┫树树树树树土土土土土土水水水水水树树树树树树树树树树树树树树树树树树树树树树树树树树草草土土树树树树树树树树树树土水水土树土飾土土李树树树树树树树树树
水水水┣┣┣穴┫┫穴┫树树树树树土土土土土土水水水水水树树┏┳┳┳┳┳┳┳┳┳┳┳┳┳┳┳┳┳┳┓树树树树土土土土树树树树树树树树树树土水水土土飾飾飾土土树树树树树树树树树
┳┳┳┳┣┣穴┫┫穴┫土土树树树树树树水水水水水┏┲┳┳┳┳┳┳┳┳┳┳┳┳┳┳┳┳┳┳┳┳┳┳┳┳┱┓树土土土土树树树树树树树树树树土水水土飾飾無飾飾土树树树树树树树树树
穴穴穴┏┳┣穴┫┫穴┫土土树树树树树树水水水水水┣┣树树树树树树树树树树树树树树树树树树树树树树树树┫┫树土土树树树飾飾飾飾树树树树树土水水土飾無無無飾土树树树树树树树树树
┻┻┐┣穴┣穴┫┫穴─土土土土水水水水水水┏┲┳┳┳树树树树树树树树树树树树树树树树树树树树树树树树┫┫树土土树树树飾飾飾飾树树树树树土土土土無無门無無土树树树树树树树树树
水水┣┣┏┳穴┫┫穴┫土土土土水水水水水水┣┣树树树树树树树树树树树树树树树树树树树树树树树树树树树┫┫树土土树树树無無無無土土土土土花土花土道道道道道道树树树树树树树树树
水水┣┣┣穴穴┫┫穴┫水水水圯水水┏┲┳┳┳┳树树树树树树树树树树树树树树树树树树树树树树树树树树树┫┫树土土树树树無门館無土树土树土土花土花道道道道道道树树树树树树树树树
水水┣┣┣穴穴┫┫穴┫水水水圯水水┣┣树树树树树树树树树树树树树树树树树树树树树树树树树树树树树树树┫┫树土土土土土道道道道土土土土土飾飾飾飾道道树树土土土土土土土草草草草
水水┣┣┣穴穴┫┫穴┫水水土土土土┣┣树树树树树树树树树树树树树树树树树树树树树树树树树树树树树树树┫┫树土土土土土道道道道土土土土土飾飾飾飾道道树树土土土土土土土草草草草
橋橋橋橋橋穴穴┫┫穴┫水水土土土土┣┣树树树树树树树树树树树树树树树树树树树树树树树树树树树树树树树┫┫树树树树树树土土道道土树土树土無無無無道道树树树树树树树草草树树树树
水水┣┣┗┗║┛┫穴┫水水土土土土┣┣树树树树树树树树树树树树树树树树树树树树树树树树树树树树树树树┫┫树树树树树树土土道道土土土土土無门買無道道树树树树树树树草草树树树树
水水┣┗┻┐穴穴┫穴┫水水土土土土┣┣树树树树树树树树树树树树树树树树树树树树树树树树树树树树树树树┫┫树树树树树树土土道道飾飾飾飾道道道道道道道树树树树树树树土土树树树树
水水┗┻┐┗┻║┛穴┫水水┏┲┳┳┳┳树树树树树树树树树树树树树树树树树树树树树树树树树树树树树树树┫┫树树树树树树土土道道無门無無道道道道道道道树树树树树树树土土树树树树
水水水水┣穴穴穴穴穴┫水水┣┣树树树树树树树树树树树树树树树树树树树树树树树树树树树树树树树树树树树┫┫树树树树树树水水道道道道道道道道水水水水水树树树草草草草土土树畑畑畑
水水水水┣穴穴┌┻┻┛水水┣┣树树树树树树树树树树树树树树树树树树树树树树树树树树树树树树树树树树树┫┫树树树树树树水水道道道道道道道道水水水水水树树树草草草草土土树畑畑畑
┳┓水水┣穴穴┫水水水水水┣┣树树树树树树树树树树树树树树树树树树树树树树树树树树树树树树树树树树树┫┫树树树树树树水水飾飾飾飾土土树树树树树树树树树树草草土土树树树畑畑畑
树┫水水┗┻┻┛水水水水水┣┣树树树树树树树树树树树树树树树树树树树树树树树树树树树树树树树树树树树┫┫树树树树树树水水無门無無土土树树树树树树树树草草草草土土树树树畑畑畑
树┫水水水水水水水水┏┲┳┳┳树树树树树树树树树树树树树树树树树树树树树树树树树树树树树树树树树树树┫┫树树树树树树水水土土土土土土树树树树树树树树草草草草草草草草树畑畑畑
树┫水水水水水水水水┣┣石树树树树树树树树树树树树树树树树树树树树树树树树树树树树树树树树树树树树树┫┫树树树树树树水水土土土土土土树树树树树树树树土土树树草草草草树畑畑畑
┳┳┳┳┳┳┳┳┳┳┳┳石石树树树树树树树树树树树树树树树树树树树树树树树树树树树树树树树树树树树树┫┫树树树树树树树树树树树树树树树树树树树树树树土土树树草草草草树畑畑畑
树树树树树树树树树树树树树石树树树树树树树树树树树树树树树树树树树树树树树树树树树树树树树树树树树树┫┫树树树树树树树树树树树树树树树树树树树树树树草草草草草草土土飾飾飾飾
树树树树树树树树树树树树树石树树树树树树树树树树树树树树树树树树树树树树树树树树树树树树树树树树树树┫┫树树树树树树树树树树树树树树树树树树树树树树草草草草草草土土無门無無
树树树树树树树树树树树树树石树树树树树树树树树树树树树树树树树树树树树树树树树树树树树树树树树树树树┫┫树树树树树树树树树树树树树树树树树树树树树树草草草草草草草草土土土土
树树树树树树树树树树树树树石树树树树树树树树树树树树树树树树树树树树树树树树树树树树树树树树树树树树┫┫树树树树树树树树树树树树树树树树树树树树树树草草草草草草草草土土土土
树树树树树树树树树树树树树石树树树树树树树树树树树树树树树树树树树树树树树树树树树树树树树树树树树树┫┫树树树树树树树树树树树树树树树树树树树树树树草草土土树树草草草草树树
树树树树树树树树树树树树树石树树树树树树树树树树树树树树树树树树树树树树树树树树树树树树树树树树树树┫┫树树树树树树树树树树树树树树树树树树树树树树草草土土树树草草草草树树
树树树树树树树树树树树树树石树树树树树树树树树树树树树树树树树树树树树树树树树树树树树树树树树树树树┫┫树树树树树树树树树树树树树树树树树树树树树树树树草草草草草草草草树树
