穴穴穴穴穴穴穴穴穴穴穴穴穴穴穴穴穴穴穴穴穴穴穴穴穴穴穴穴穴穴穴穴穴穴穴穴穴穴穴┫水水水水水水水水水水┗┐
穴穴穴穴穴穴穴穴穴穴穴穴穴穴穴穴穴穴穴穴穴穴穴穴穴穴穴穴穴穴穴穴穴穴穴穴穴穴穴┳┳┓水水水水水水水水水┣
穴穴穴穴穴穴穴穴穴穴穴穴穴穴穴穴穴穴穴穴穴穴穴穴穴穴穴穴穴穴穴穴穴穴穴穴穴穴穴穴穴┫水水水水水水水水水┗
穴穴穴穴穴穴穴穴穴穴穴穴穴穴穴穴穴穴穴穴穴穴穴穴穴穴穴穴穴穴穴穴穴穴穴穴穴穴穴穴穴┳┳┓水水水水水水水水
穴穴穴穴穴穴穴穴穴穴穴穴穴穴穴穴穴穴穴穴穴穴穴穴穴穴穴穴穴穴穴穴穴穴穴穴穴穴穴穴┌┻┻┐水水水水水水水水
┐穴穴穴穴穴穴穴穴穴穴穴穴穴穴穴穴穴穴穴穴穴穴穴穴穴穴穴穴穴穴穴穴穴穴穴穴穴穴穴┫飾飾飾飾水水水水水水水
┗┐穴穴穴穴穴穴穴穴穴穴穴穴┌┻┻┻┻┻┻┐穴穴穴穴穴穴穴穴穴穴穴穴穴穴穴穴穴穴┫無门無無水水水水水水水
树┗┐穴穴穴┌入┐穴穴穴穴穴┫水水水水水水┣穴穴穴穴穴穴穴穴穴穴穴穴穴穴穴穴┌入┛土土土土水水水水水水水
树树┗┐穴穴┫穴┗┻┻┻┻┻┛水水水水水水┣穴穴穴穴穴穴穴穴穴穴穴穴穴穴穴穴┫穴石石土土树水水水水水水水
树树树┗┻┐┫穴穴穴穴穴穴穴穴滝滝穴穴穴穴┗┻┻┐穴穴穴穴穴穴穴穴穴穴穴穴穴┫穴石石石土土砂水水水水水水
树树树树树┣┳┳┳┓水水水水水水水┏┓穴穴穴穴穴┣穴穴穴穴穴穴穴穴穴穴穴穴穴┫穴穴穴穴土土砂水水水水水水
树树树树树┗┻┻┻┛水水水水水水水┣┳┳┳┳┓穴┣穴穴穴穴穴穴穴穴穴穴穴穴穴┳┳┳┳┓土土砂水水水水水水
树水水水水水水水水水水水┏┳┳┳┳┳穴穴穴穴┫穴┣穴穴穴穴穴穴穴穴穴穴穴穴穴穴穴穴穴┫土李砂水水水水水水
树水水水水水水水水水水水┣穴穴穴穴穴穴穴穴穴┫穴┣穴穴穴穴穴穴穴穴穴穴穴穴穴穴穴穴穴┫土土水水水水水水水
树水水树树树树树树树┏┳┳穴穴穴穴穴穴穴┌入┛穴┣穴穴穴穴穴穴穴穴穴穴穴穴穴穴穴穴穴┫土土水水水水水水水
水水水树树树树树树树┣穴穴穴穴穴穴穴穴穴┫穴穴穴┣穴穴穴穴穴穴穴穴穴穴穴┌┻┻┻┻┐┫土水水水水水水水水
水水水树树树树树树树┣穴穴穴穴穴穴穴穴穴┫穴穴穴┣穴穴穴穴穴穴穴穴穴穴穴┣飾飾飾飾┣┫李水水水水水水水水
飾飾树树树树树树树树┣穴穴穴穴穴穴穴穴穴┳┳┳┳┳穴穴穴┌┻┻┻┻┻┻┻┛無门無無┣┫水水水水水水水水水
無無树树树树树树树树┣穴穴穴穴穴穴穴穴穴穴穴穴穴穴穴穴穴┫稂稂稂稂稂稂稂稂稂稂稂稂┗┛水水水水水水水水水
土李树树树树树树树树┣穴穴┌入┐穴穴穴穴穴穴穴穴穴穴穴穴┫稂稂稂稂稂稂稂稂稂稂稂稂水水水水水水水水水水水
稂稂稂稂稂稂稂稂树树┗┻┻┛穴┣穴穴穴穴穴穴穴穴穴穴穴穴┫稂稂稂稂水水水水水水水水水水水水水水水水水水水
稂稂树稂树稂稂稂树树穴穴穴穴穴┣穴穴穴穴穴穴穴穴穴穴穴穴┫稂稂稂稂水水水水水水水水水水水水水水水水水水水
稂稂稂稂稂稂树树树树穴┏┳┳┳┳穴穴穴穴穴穴穴穴穴穴穴穴┫稂稂水水水水水水水水水水水水水水水水水水水水水