树树树树树穴穴穴穴穴穴穴穴穴穴穴穴穴穴┫┫水水水水水水水水水水┗┐穴穴穴穴穴穴穴穴┣穴穴穴穴穴穴穴穴穴穴穴
穴穴穴穴穴穴穴穴穴穴穴穴穴穴穴穴穴穴穴┳┳┱┓水水水水水水水水水┣穴穴穴穴穴穴穴穴┣穴穴穴穴穴穴穴穴穴穴穴
穴穴穴穴穴穴穴穴穴穴穴穴穴穴穴穴穴穴穴穴穴┫┫水水水水水水水水水┗┻┐穴穴穴穴穴穴┣穴穴穴穴穴穴穴穴穴穴穴
穴穴穴穴穴穴穴穴穴穴穴穴穴穴穴穴穴穴穴穴┌┛┳┳┓水水水水水水水水水┗┻┐穴穴穴穴┣穴穴穴穴穴穴穴穴穴穴穴
穴穴穴穴穴穴穴穴穴穴穴穴穴穴穴穴穴穴穴穴┫┌┻┻┛水水水水水水水水水水水┗┻┐穴穴┣穴穴穴穴穴穴穴穴穴穴穴
┻┻┻┐穴穴穴穴穴穴穴穴穴穴穴穴穴穴穴穴┫┫飾飾飾飾水水水水水水水水水水水水┗┐穴┣穴穴穴穴穴穴穴穴穴穴穴
┻┻┐┣穴穴穴穴穴穴穴穴穴穴穴穴穴穴┌入┛┫無门無無水水水水水水水水水水水水水┗┐┣穴穴穴穴穴穴穴穴穴穴穴
水水┣┣穴穴穴穴穴穴穴穴穴穴穴穴穴穴┫┌入┛土土土土水水水水水水水水水水水水水水┣┣穴穴穴穴穴穴穴穴穴穴穴
水水┣┗┻┻┐穴穴穴穴穴穴穴穴穴穴穴┫┫穴石石土土树水水水水水水水水水水水水水水┣┣穴穴穴穴穴穴穴穴穴穴穴
穴穴┗┻┻┐┣穴穴穴穴穴穴穴穴穴穴穴┫┫穴石石石土土砂水水水水水水水水水水水水┏┳┣穴穴穴穴穴穴穴穴穴穴穴
穴穴穴穴穴┣┣穴穴穴穴穴穴穴穴穴穴穴┫┫穴穴穴穴土土砂水水水水水水水水水水水水┣┏┳穴穴穴穴穴穴穴穴穴穴穴
┳┳┳┓穴┣┣穴穴穴穴穴穴穴穴穴穴穴┳┳┳┳┱┓土土砂水水水水水水水水水水水水┣┣穴穴穴穴穴穴穴穴穴穴穴穴
┳┳┓┫穴┣┣穴穴穴穴穴穴穴穴穴穴穴穴穴穴穴┫┫土李砂水水水水水水水水水水水水┣┗┐穴穴穴穴穴穴穴穴穴穴穴
┌入┛┫穴┣┣穴穴穴穴穴穴穴穴穴穴穴穴穴穴穴┫┫土土水水水水水水水水水水水水水┗┐┣穴穴穴穴┌┻┻┻┻┻┻
┫┌入┛穴┣┣穴穴穴穴穴穴穴穴穴┌┻┻┻┻┻┛┫土土水水水水水水水水水水水水水水┣┗┐穴穴穴┫┌┻┻┻┻┻
┫┫穴穴穴┣┣穴穴穴穴穴穴穴穴穴┣┌┻┻┻┻┐┫土水水水水水水水水水水水水水水水┗┐┗┻┻┻┛┫水水水水水
┫┫穴穴穴┣┣穴┌┻┻┻┻┻┻┻┛┣飾飾飾飾┣┫李水水水水水水水水水水水水水水水水┗┻┻┻┻┻┛水水水水水
┫┳┳┳┳┳┣穴┫┌┻┻┻┻┻┻┻┛無门無無┣┫水水水水水水水水水水水水水水水水水水水水飾飾飾飾飾飾飾水水
┲┲┲┱┱┱┱┓┫┫稂稂稂稂稂稂稂稂稂稂稂稂┗┛水水水水水水水水水水水水水水水水水水水水飾飾飾飾飾飾飾水水
┣┣┗┛┫┫┫┫┫┫稂稂稂稂稂稂稂稂稂稂稂稂水水水水水水水水水水水水水水水水水水水水水水無無無無無無無水水
┣┗┻┻┛┫┫┫┫┫稂稂稂稂水水水水水水水水水水水水水水水水水水水水水水水水水水水水水水無無無门無無無水水
┗┻┻┻入┛┫┫┫┫稂稂稂稂水水水水水水水水水水水水水水水水水水水水水水水水水水水水水水道道道道道道道道飾
┻┻入┻║┻┛┫┫┫稂稂水水水水水水水水水水水水水水水水水水水水水水水水水水水水水水水水飾飾道道道飾飾道無
┻┐穴穴穴┌┻┛┫┫稂稂水水水水水水水水水水水水水水水水水水水水水水水水水水水水水水水水無無道道道無無道道
李┗┻┻┻┛李草┫┫稂稂稂稂稂稂水水水水水水水水水水水水水水水水水水水水水水水水水水┏┳┳┳┳││┳┳┳┳
草草草草草草草李┫┫稂稂稂稂稂稂水水水水水水水水水水水水水水水水水水水水水水水水水水┣穴穴穴穴穴穴穴穴穴穴
李草飾飾飾飾李草┫┫水水水水圯圯水水水水水水水水水水水水水水水水水水水水水水水水水水┣穴穴穴穴穴穴穴穴穴穴
草李無门無無草李┫┫水水水水圯圯水水水水水水水水水水水水水水水水水水水水水水水水水水┗┐┏┳┳││┳┳┳┳
李草李土李草李草┫┫水水水水草草水水草草草草砂砂砂砂砂砂砂水水水水水水水水水水水水水水┣┣┏┓草草稂稂树树
草李草土草李草李┫┫水水水水草草水水草草草草砂砂砂砂砂砂砂水水水水水水水水水水水水水水┣┣┣┫草草稂稂树树
土土土土土土┏┓┫┫水水草草草草草草草草石石石石石石石砂砂砂砂水水水水水水水水水水水水┣┣┗┛草草稂稂树树
土土土土土土┗┛┫┫水水草草草草草草草草石石石石石石石砂砂砂砂水水水水水水水水水水水水┣┗┻┐草草稂稂树树
土土土土土土土土──橋橋草草草草草草草草草草草草草草草草草砂砂砂砂砂砂砂砂砂砂砂砂水水┣稂稂═草草草草稂稂
┓土土土土土土土──橋橋草草草草草草草草草草草草草草草草草砂砂砂砂砂砂砂砂砂砂砂砂水水┣稂稂═草草草草稂稂
─土土┌┻┻┻┻┛┫水水石石石石石石石石石石石石草草草草草草草草草草草草草草草草草橋橋═草草═草草草草草草
─土土┫┌┻┻┻┻┛水水石石石石石石石石石石石石草草草草草草草草草草草草草草草草草橋橋═草草═草草草草草草
┛┌┻┛┫水水水水水水水石石石石石石石石石石石石石石石石石石石石石石石石石石石石石水水┣草草┣┏┳┳┳┳┓
穴┫┌┻┛水水水水水水水石石石石石石石石石石石石石石石石石石石石石石石石石石石石石水水┣草草┣┣穴穴穴穴┫
穴┫┫水水水水石石石石石石石石石石石石石石石石石石石石石石石石石石石石石石石石石石水水┣草草┣┗┐穴穴穴┳
穴┫┫水水水水石石石石石石石石石石石石石石石石石石石石石石石石石石石石石石石石石石水水┣草草┗┐┣┏┳┳┳
穴┫┫水水石石石石石石石石石石石石石石石石石石石石石石石石石石石石石石石石石石石石水水┗┻┻┐┣┣┣稂稂稂
穴┫┫水水石石石石石石石石石石石石石石石石石石石石石石石石石石石石石石石石石石石石水水水水水┣┣┣┣稂稂稂
穴┫┫水水石石石石石石石石石石石石石石石石石石石石石石石石石石石石石石石石石石石石水水水水水┣┣┣┣稂稂稂
穴┫┫水水石石石石石石石石石石石石石石石石石石石石石石石石石石石石石石石石石石石石石石石水水┣┣┣┣稂稂稂
穴┫┫水水石石石石石石石石石石石石石石石石石石石石石石石石石石石石石石石石石石石石石石石水水┣┣┣┗┻┻┻
穴┫┫水水水水石石石石石石石石石石石石石石石石石石石石石石石石石石石石石石石石石石石石石水水┣┣┗┻┻┻┐
穴┫┫水水水水石石石石石石石石石石石石石石石石石石石石石石石石石石石石石石石石石石石石石水水┣┗┻┻┻┐┣
石石石石石水水石石石石石石石石石石石石石石石石石石石石石石石石石石石石石石石石石石石石石水水┗┻┻┻┐┣┣
石石石石石水水石石石石石石石石石石石石石石石石石石石石石石石石石石石石石石石石石石石石石水水水水水水┣┣┣
石石石石石水水石石石石石石石石石石石石石石石石石石石石石石石石石石石石石石石石石石石石石水水水水水水┣┣┣
石石石石石石石石石石石石石石石石石石石石石石石石石石石石石石石石石石石石石石石石石石石石石石石石水水┣┣┗
石石石石石石石石石石石石石石石石石石石石石石石石石石石石石石石石石石石石石石石石石石石石石石石石水水┣┗┻
石石石石石石石石石石石石石石石石石石石石石石石石石石石石石石石石石石石石石石石石石石石石石石石石水水┗┻┻
石石石石石石石石石石石石石石石石石石石石石石石石石石石石石石石石石石石石石石石石石石石石石石石石水水水水水
石石石石石石石石石石石石石石石石石石石石石石石石石石石石石石石石石石石石石石石石石石石石石石石石水水水水水
石石石石石石石石石石石石石石石石石石石石石石石石石石石石石石石石石石石石石石石石石石石石石石石石石石石水水
石石石石石石石石石石石石石石石石石石石石石石石石石石石石石石石石石石石石石石石石石石石石石石石石石石石水水
石石石石石石石石石石石石石石石石石石石石石石石石石石石石石石石石石石石石石石石石石石石石石石石石石石石水水
石石石石石石石石石石石石石石石石石石石石石石石石石石石石石石石石石石石石石石石石石石石石石石石石石石石水水
石石石石石石石石石石石石石石石石石石石石石石石石石石石石石石石石石石石石石石石石石石石石石石石石石石石水水
石石石石石石石石石石石石石石石石石石石石石石石石石石石石石石石石石石石石石石石石石石石石石石石石石石石石石
石石石石石石石石石石石石石石石石石石石石石石石石石石石石石石石石石石石石石石石石石石石石石石石石石石石石石
石石石石石石石石石石石石石石石石石石石石石石石石石石石石石石石石石石石石石石石石石石石石石石石石石石石石石
石石石石石石石石石石石石石石石石石石石石石石石石石石石石石石石石石石石石石石石石石石石石石石石石石石石石石
石石石石石石石石石石石石石石石石石石石石石石石石石石石石石石石石石石石石石石石石石石石石石石石石石石石石石
