树树树树树树树树树树树树树树树树树树水水水水树树树树土土树树树树树树树树树树树树树树树树树树树树水水水水水水水水水水水┣穴穴穴穴穴穴穴穴穴┫穴┣穴穴穴穴穴穴穴穴穴穴穴穴穴
树树树树树树树树树树树树树树树树树水水水水树树树树树土土树树树树树树树树树树树树树树树树树树树树水水树树树树树树树┏┳┳穴穴穴穴穴穴穴┌入┛穴┣穴穴穴穴穴穴穴穴穴穴穴穴穴
树树树树树树树树树树树树树树水水水水水水水树树树树树土土树树树树树树树树树树树树树树树水水水水水水水树树树树树树树┣穴穴穴穴穴穴穴穴穴┫穴穴穴┣穴穴穴穴穴穴穴穴穴穴穴┌┻
树树树树树树树树树树树树树树水水水水水水树树树树树树土土树树树树树树树树树树树树树树树水水水水水水水树树树树树树树┣穴穴穴穴穴穴穴穴穴┫穴穴穴┣穴穴穴穴穴穴穴穴穴穴穴┣飾
树树树树树树树树树树树树树树水水水土土土土土土土土土土土树树树树树树树树树树树树树树树水水飾飾飾飾树树树树树树树树┣穴穴穴穴穴穴穴穴穴┳┳┳┳┳穴穴穴┌┻┻┻┻┻┻┻┛無
树树树树树树树树树树树树树树水水水土土土土土土土土土土土树树树树树树树树树树树树树树树水水無门無無树树树树树树树树┣穴穴穴穴穴穴穴穴穴穴穴穴穴穴穴穴穴┫稂稂稂稂稂稂稂稂稂
树树树树树树树树树树树树树树水水水土土树树树树树树树树树树树树树树树树树树树树树树树树水水土土土李树树树树树树树树┣穴穴┌入┐穴穴穴穴穴穴穴穴穴穴穴穴┫稂稂稂稂稂稂稂稂稂
树树树树树树树树树树树树树树水水水土土树树树树树树树树树树树树树树树树树树树树树树水水水水土土稂稂稂稂稂稂稂稂树树┗┻┻┛穴┣穴穴穴穴穴穴穴穴穴穴穴穴┫稂稂稂稂水水水水水
树树树树树树树树树树树树树水水水水土土树树树树树树树树树树树树树树树树树树树树树树水水水水土土稂稂树稂树稂稂稂树树穴穴穴穴穴┣穴穴穴穴穴穴穴穴穴穴穴穴┫稂稂稂稂水水水水水
树树树树树树树树树树树树土水水水树土土树树树树树树树树树树树树树树树树树树树树水水水水土土土草稂稂稂稂稂稂树树树树穴┏┳┳┳┳穴穴穴穴穴穴穴穴穴穴穴穴┫稂稂水水水水水水水
树树树土土土土土土土土土土橋橋道道土土树树树树树树树树树树树树树树树树树树树树水水水水土树草草稂树稂稂稂稂树畑畑畑畑┣穴穴穴穴穴穴穴穴穴穴穴穴穴穴穴穴┫稂稂水水水水水水水
树树树土土土土土土土土土土橋橋道道土土土土草树树树树树树树树树树树树树树树树树水水土土土草草草稂稂稂树稂稂树畑畑畑畑┣穴穴穴穴穴穴穴李草李草李草李草穴┫稂稂稂稂稂稂水水水
树树树土土树树树草草土土水水水道道土土土土草草草草树树树树树树树树树树树树树树水水土土草草草草稂稂稂稂稂稂树畑畑畑畑┗┻┐岩岩岩岩穴草李草李草李草李穴┫稂稂稂稂稂稂水水水
树树树土土树树树树草土土水水水道道土土土土土树草草草草树树树树树树树树树树树树水水土土稂稂稂稂稂稂稂稂树稂树畑畑畑畑穴穴═穴穴穴岩穴李草飾飾飾飾李草穴┫水水水水圯圯水水水
树树树土土树树树树草土土水水水道道飾飾飾飾土土土树草草草草草草草树树树树树树树水水土土稂稂稂稂稂稂树稂稂稂树畑畑畑畑穴穴═穴穴穴岩岩草李無门無無草李穴┫水水水水圯圯水水水
树树树土土树树树树草土土水水水道道無门無無道道土土土树草草草道道道道道道道道道道道土土草草草草稂稂稂稂稂稂飾飾飾飾土穴穴┣岩穴穴岩岩李草李土李草李草穴┫水水水水草草水水草
稂稂树土土树树树树草土土水水水道道道道道道道道土土土土土土树道道道道道道道道道道道土土草草草草稂稂稂稂稂稂無门無無土穴穴┣岩穴穴岩岩草李草土草李草李穴┫水水水水草草水水草
稂树稂草草树树树树草土土水水水花土道道道道树道道道道道道道道道道树树树树树树树水水树树树树草草草草草草草草土土土土土土土┣岩穴穴岩岩土土土土土土土土穴┫水水草草草草草草草
稂稂稂草草树树树树草土土水水水土花道道道道道道道道道道道道道道道树树树树树树树水水树树树树草草草草草草草草土土土土土土土┣岩穴穴岩岩土土土土土土土土穴┫水水草草草草草草草
稂稂稂草草树树树树草土土水水水花土道道飾飾飾飾道道树树树土土道道树树树树水水水水水树树树树树树树树树树树树树树树┏┳┳┳┳岩穴穴岩岩穴穴岩石石石土土土─橋橋草草草草草草草
草草草草草树树树树树土土水水水土花道道飾飾飾飾道道树树树树土道道树水水水水水水水水树树树树树树树树树树树树树┏┳┳岩石石石岩穴穴岩岩穴穴岩石石石土土土─橋橋草草草草草草草
草草草草草树树树树树土土水水水土土道道無無無無道道树树树树树道道水水水水水水水树树树树树树树树树树树树树┏┳┳石石石石石石岩穴穴穴穴穴穴岩石石石石石石┫水水石石石石石石石
树树树树树树树树树树土土水水飾飾飾飾道無门館無道飾飾飾飾水水圯圯水水水树树树树树树树树树树树树树树树树┏┳石石石石石石石石岩穴穴穴穴穴穴岩石┌┻┻┻┻┛水水石石石石石石石
树树树树树树树树树树土土水水無门無無道道道道道道無门無無水水圯圯水水树树树树树树树树树树树树树树树┏┳┳石石石石石石石石石岩岩岩岩岩岩岩岩石┫水水水水水水水石石石石石石石
树树树树树树树树树树土土水水水道道道道道道道道道道道水水水水土土土土树树树树树树树树树树树树树┏┳┳石石石石石石石石石石石石石石石石石石┌┻┛水水水水水水水石石石石石石石
树树树树树树树树树树土土水水水水水水水水水水水水水水水水水土土土土树树树树树树树树树树树树┏┳┳石石石石石石石石石石石石石石石石石石石石┫水水水水石石石石石石石石石石石石
树树树树树树树树树树土土草水水水水水水水水水水水水水水土土土土土树树树树树树树树树树树树┏┳石石石石石石石石石石石石石石石石石石石石石石┫水水水水石石石石石石石石石石石石
树树树树树树树树树树土土草水水水水水水水水水水水土土土土土土土树树树树树树树树树树树树树┣石石石石石石石石石石石石石石石石石石石石石石石┫水水石石石石石石石石石石石石石石
树树树树树树土土土土土土土橋橋土土土土土土土土土土土土土树树树树树树树树树树树树树树树树┣石石石石石石石石石石石石石石石石石石石石石石石┫水水石石石石石石石石石石石石石石
树树树树树树土土土土土土土橋橋土土土土土土土土土土树树树树树树树树树树树树树树树树树树树┣石石石石石石石石石石石石石石石石石石石石石石石┫水水石石石石石石石石石石石石石石
树树树树树树土土树树树树树水水树树树树树树树树树树树树树树树树树树树树树树树树树树树树树┣石石石石石石石石石石石石石石石石石石石石石石石┫水水石石石石石石石石石石石石石石
树树树树树树土土树树树树树水水树树树树树树树树树树树树树树树树树树树树树树树树树树树树树┣石石石石石石石石石石石石石石石石石石石石石石石┫水水石石石石石石石石石石石石石石
树树树树树树土土树树树树水水水树树树树树树树树树树树树树树树树树树树树树树树树树树树树树┣石石石石石石石石石石石石石石石石石石石石石石石┫水水水水石石石石石石石石石石石石
树树树树树树土土树树树树水水水树树树树树树树树树树树树树树树树树树树树树树树树树树树树树┣石石石石石石石石石石石石石石石石石石石石石石石┫水水水水石石石石石石石石石石石石
树树树树树树土土树树树树水水水树树树树树树树树树树树树树树树树树树树树树树树树树树树树树┣石石石石石石石石石石石石石石石石石石石石石石石石石石水水石石石石石石石石石石石石
树树树树树树土土树树树树水水水树树树树树树树树树树树树树树树树树树树树树树树树树树树树树┣石石石石石石石石石石石石石石石石石石石石石石石石石石水水石石石石石石石石石石石石
树树树树树树道道树树树树水水水树树树树树树树树树树树树树树树树树树树树树树树树树树树树树┣石石石石石石石石石石石石石石石石石石石石石石石石石石水水石石石石石石石石石石石石