石石石石石石石石石石石石石石石石石石石石石石石石石石石石石石石石石石石石石石石石石石石石
石石石石石石石石石石石石石石石石石石石石石石石石石石石石石石石石石石石石石石石石石石石石
石石石石石石石石石石石石石石石石石石石石石石石石石石石石石石石石石石石石石石石石石石石石
石石石石石石石石石石石石石石石石石石石石石石石石石石石石石石石石石石石石石石石石石石石石
石石石石石石石石石石石石石石石石石石石石石石石石石石石石石石石石石石石石石石石石石石石石
石石石石石石石石石石石石石石石石石石石石石石石石石石石石石石石石石石石石石石石石石石石石
石石石石石石石石石石石石石石石石石石石石石石石石石石石石石石石石石石石石石石石石石石石石
石石石穴穴穴穴穴穴穴穴穴穴穴穴穴穴穴穴穴穴穴穴穴穴穴穴穴穴穴穴穴穴穴穴穴石石石石石石石石
石石石穴石石石石石石石石水石石石石石石石石石石石石石石石石石石石石石石穴石石石石石石石石
石石石穴石石石石石石石石水石石石石石石石石石石石石石石石石石石石石石石穴石石石石石石石石
石石石入石石石石石石石石水石石石石石石石石石石石石石石石石石石石石石石入石石石石石石石石
石石石石石石石石石石石石水石石石石石石石石石石石石石石石石石石石石石石石石石石石石石石石
石石石石石石石石石石石石水石石石石石石石石石石石石石石石石石石石石石石石石石石石石石石石
石石石石石石石石石石石石水石石石石石石石石石石石石石石石石石石石石石石石石石石石石石石石
石石石石石石石石石石石石水岩石岩石石石石石石石石石石石石石石石石石石石石石石石石石石石石
石石石石石石石石石石石石水石石岩岩石石石石石石石石石石石石石石石石石石石石石石石石石石石
石石石石石石石石石石石石滝穴穴穴穴穴岩石石石石石石石石石石石石石石石石石石石石石石石石石
石石石石石石石石石石石石水穴石石岩入石石石石石石石石石石石石石石石石石石石石石石石石石石
石石石水水水水水水水水水水穴穴岩石石石石石石石石石石石石石石石石石石石石石石石石石石石石
石石石石石石石石石石石岩石石穴石岩石石石石石石石石石石石石石石石石石石石石石石石石石石石
石石石石石石石石石石穴穴穴石穴石石石石石石石石石石石石石石石石石石石石石石石石石石石石石
石石石石石石石石石岩穴石穴岩穴岩石石石石石石石石石石石石石石石石石石石石石石石石石石石石
石石石石石石石石石石入岩穴穴穴石石石石石石石石石石石石石石石石石石石石石石石石石石石石石
石石石石石石石石石石石石石石石石石石石石石石石石石石石石石石石石石石石石石石石石石石石石
石石石石石石石石石石石石石石石石石石石石石石石石石石石石石石石石石石石石石石石石石石石石
石石石石石石石石石石石石石石石石石石石石石石石石石石石石石石石石石石石石石石石石石石石石
石石石石石石石石石石石石石石石石石石石石石石石石石石石石石石石石石石石石石石石石石石石石
石石石石石石石石石石石石石石石石石石石石石石石石石石石石石石石石石石石石石石石石石石石石