穴穴穴穴穴穴穴穴穴穴穴穴穴穴穴穴穴┫水水水水水水水水水水┗┐穴穴穴穴穴穴穴穴┣穴穴穴穴穴穴穴穴穴穴穴穴穴穴穴穴穴穴穴穴穴穴穴穴穴穴穴穴穴穴穴穴穴穴穴穴穴穴穴穴穴穴穴穴
穴穴穴穴穴穴穴穴穴穴穴穴穴穴穴穴穴┳┳┓水水水水水水水水水┣穴穴穴穴穴穴穴穴┣穴穴穴穴穴穴穴穴穴穴穴穴穴穴穴穴穴穴穴穴穴穴穴穴穴穴穴穴穴穴穴穴穴穴穴穴穴穴穴穴穴穴穴穴
穴穴穴穴穴穴穴穴穴穴穴穴穴穴穴穴穴穴穴┫水水水水水水水水水┗┻┐穴穴穴穴穴穴┣穴穴穴穴穴穴穴穴穴穴穴穴穴穴穴穴穴穴穴穴穴穴穴穴穴穴穴穴穴穴穴穴穴穴穴穴穴穴穴穴穴穴穴穴
穴穴穴穴穴穴穴穴穴穴穴穴穴穴穴穴穴穴穴┳┳┓水水水水水水水水水┗┻┐穴穴穴穴┣穴穴穴穴穴穴穴穴穴穴穴穴穴穴穴穴穴穴穴穴穴穴穴穴穴穴穴穴穴穴穴穴穴穴穴穴穴穴穴穴穴穴穴穴
穴穴穴穴穴穴穴穴穴穴穴穴穴穴穴穴穴穴┌┻┻┐水水水水水水水水水水水┗┻┐穴穴┣穴穴穴穴穴穴穴穴穴穴穴穴穴穴穴穴穴穴穴穴穴穴穴穴穴穴穴穴穴穴穴穴穴穴穴穴穴穴穴穴穴穴穴穴
穴穴穴穴穴穴穴穴穴穴穴穴穴穴穴穴穴穴┫飾飾飾飾水水水水水水水水水水水水┗┐穴┣穴穴穴穴穴穴穴穴穴穴穴穴穴穴穴穴穴穴穴穴穴穴穴穴穴穴穴穴穴穴穴穴穴穴穴穴穴穴穴穴穴穴穴穴
穴穴穴穴穴穴穴穴穴穴穴穴穴穴穴穴穴穴┫無门無無水水水水水水水水水水水水水┗┐┣穴穴穴穴穴穴穴穴穴穴穴穴穴穴穴穴穴穴穴穴穴穴穴穴穴穴穴┏┲┳┲┳┳┳┳┳┳┳┳┳┳┳┳┳
穴穴穴穴穴穴穴穴穴穴穴穴穴穴穴穴┌入┛土土土土水水水水水水水水水水水水水水┣┣穴穴穴穴穴穴穴穴穴穴穴穴穴穴穴穴穴穴穴穴穴穴穴穴穴穴穴┣┣穴┣穴穴水水水水穴穴穴穴穴穴穴
穴穴穴穴穴穴穴穴穴穴穴穴穴穴穴穴┫穴石石土土树水水水水水水水水水水水水水水┣┣穴穴穴穴穴穴穴穴穴穴穴穴穴穴穴穴穴穴穴穴穴穴穴穴穴穴穴┣┣穴┣穴穴水水水水穴穴穴穴穴穴穴
┻┻┐穴穴穴穴穴穴穴穴穴穴穴穴穴┫穴石石石土土砂水水水水水水水水水水水水┏┳┣穴穴穴穴穴穴穴穴穴穴穴穴穴穴穴穴穴穴穴穴穴穴穴穴穴穴穴┣┣穴┣┌┻┻┻滝滝┻┻┻┐穴穴穴
穴穴┣穴穴穴穴穴穴穴穴穴穴穴穴穴┫穴穴穴穴土土砂水水水水水水水水水水水水┣┏┳穴穴穴穴穴穴穴穴穴穴穴穴穴穴穴穴穴穴穴穴穴穴穴穴穴穴穴┣┣穴┣┫┌┻┻滝滝┻┻┐┣穴穴穴
┓穴┣穴穴穴穴穴穴穴穴穴穴穴穴穴┳┳┳┳┓土土砂水水水水水水水水水水水水┣┣穴穴穴穴穴穴穴穴穴穴穴穴穴穴穴穴穴穴穴穴穴穴穴穴穴穴穴穴┣┣穴┣┫┫┌┻滝滝┻┐┣┣穴穴穴
┫穴┣穴穴穴穴穴穴穴穴穴穴穴穴穴穴穴穴穴┫土李砂水水水水水水水水水水水水┣┗┐穴穴穴穴穴穴穴穴穴穴穴穴穴穴穴穴穴穴穴穴穴穴穴穴穴穴穴┣┣穴┣┫┫┫┌滝滝┐┣┣┣穴穴穴
┫穴┣穴穴穴穴穴穴穴穴穴穴穴穴穴穴穴穴穴┫土土水水水水水水水水水水水水水┗┐┣穴穴穴穴┌┻┻┻┻┻┻┻┻┻┐穴穴穴穴穴穴穴穴穴穴穴穴┣┣穴┣┫┫┫┫水水┣┣┣┗┻┻┻
┛穴┣穴穴穴穴穴穴穴穴穴穴穴穴穴穴穴穴穴┫土土水水水水水水水水水水水水水水┣┗┐穴穴穴┫┌┻┻┻┻┻┻┻┐┣穴穴穴穴穴穴穴穴穴穴穴穴┣┣穴┣┫┫┫┫水水┣┣┗┻┻┻┻
穴穴┣穴穴穴穴穴穴穴穴穴穴穴┌┻┻┻┻┐┫土水水水水水水水水水水水水水水水┗┐┗┻┻┻┛┫水水水水水水水┣┣穴穴穴穴穴穴穴穴穴穴穴穴┣┣穴┣┫┫┫┫水水┣┣┌┻┻┻┻
穴穴┣穴穴穴穴穴穴穴穴穴穴穴┣飾飾飾飾┣┫李水水水水水水水水水水水水水水水水┗┻┻┻┻┻┛水水水水水水水┣┣穴穴穴穴穴穴穴穴穴穴穴穴┣┣穴┗┛┫┫┫水水┣┗┛┌┻┻┻
┳┳┳穴穴穴┌┻┻┻┻┻┻┻┛無门無無┣┫水水水水水水水水水水水水水水水水水水水水飾飾飾飾飾飾飾水水水水┣┣穴穴穴穴穴穴穴穴穴穴穴穴┣┗┻┻┻┛┫┫水水┣┌┻┛┌┻┻
穴穴穴穴穴穴┫稂稂稂稂稂稂稂稂稂稂稂稂┗┛水水水水水水水水水水水水水水水水水水水水飾飾飾飾飾飾飾水水水水┣┣穴穴穴穴穴穴穴穴穴穴穴穴┗┻┻┻┻┻┛┫水水┗┛┌┻┛树树
穴穴穴穴穴穴┫稂稂稂稂稂稂稂稂稂稂稂稂水水水水水水水水水水水水水水水水水水水水水水無無無無無無無水水水水┣┣穴穴穴穴穴穴穴穴穴穴穴穴穴穴穴穴穴穴┌┛水水水穴┫树树树树
穴穴穴穴穴穴┫稂稂稂稂水水水水水水水水水水水水水水水水水水水水水水水水水水水水水水無無無门無無無水水水水┣┣穴穴穴穴穴穴穴穴穴穴穴穴穴穴穴穴穴穴┫┌┻滝滝┻┛树树树树
穴穴穴穴穴穴┫稂稂稂稂水水水水水水水水水水水水水水水水水水水水水水水水水水水水水水道道道道道道道道飾飾┏┳┣穴穴┏┳┳┳┳┳┳┳┳┳┳┳┳┳┳┫┫┫树水水树树树树树树
穴穴穴穴穴穴┫稂稂水水水水水水水水水水水水水水水水水水水水水水水水水水水水水水水水飾飾道道道飾飾道無無┣┏┳穴穴┣穴穴穴穴穴穴穴穴穴穴穴穴穴穴┫┫┫树水水树树土树树树
穴穴穴穴穴穴┫稂稂水水水水水水水水水水水水水水水水水水水水水水水水水水水水水水水水無無道道道無無道道道┣┣┏┳┳┳┳┳┳┳┳┳┳┳┳┓穴穴穴穴┫┫┫树水水水土土土土土
草李草李草穴┫稂稂稂稂稂稂水水水水水水水水水水水水水水水水水水水水水水水水水水┏┳┳┳┳││┳┳┳┳┳┳┣┣穴穴穴穴穴穴穴穴穴穴穴穴┫穴穴穴穴┫┫┫树水水水土土土土土
李草李草李穴┫稂稂稂稂稂稂水水水水水水水水水水水水水水水水水水水水水水水水水水┣穴穴穴穴穴穴穴穴穴穴穴穴┣┗┐穴┏┳┳┳┳┳┳┳┓穴┫穴穴穴穴┫┫┫树树水水水土土土土
飾飾飾李草穴┫水水水水圯圯水水水水水水水水水水水水水水水水水水水水水水水水水水┣穴穴穴穴穴穴穴穴穴穴穴穴┣树┣穴┣穴穴穴穴穴穴穴┫穴┫穴穴穴穴┫┫┳┳┳┓水水水飾门飾
门無無草李穴┫水水水水圯圯水水水水水水水水水水水水水水水水水水水水水水水水水水┗┐┏┳┳││┳┳┳┳┳┳┳树┣穴┗┻┻┻┻┻┻┻┛穴┫穴穴穴穴┫┳┓树树┳┓水水飾飾飾
土李草李草穴┫水水水水草草水水草草草草砂砂砂砂砂砂砂水水水水水水水水水水水水水水┣┣┏┓草草稂稂树树树树树树┣穴穴穴穴穴穴穴穴穴穴穴┫树树树树┳┓┫树树┌┛水水無無無
土草李草李穴┫水水水水草草水水草草草草砂砂砂砂砂砂砂水水水水水水水水水水水水水水┣┣┣┫草草稂稂树树树树树树┗┻┻┻┻┻┻┻┻┻┻┻┛树树树树树┫┫树树┫水水水無门無
土土土土土穴┫水水草草草草草草草草石石石石石石石砂砂砂砂水水水水水水水水水水水水┣┣┗┛草草稂稂树树树树树树树树树树树树树树树树树树树树树树树树┫┫树树┫水水水道道道
土土土土土穴┫水水草草草草草草草草石石石石石石石砂砂砂砂水水水水水水水水水水水水┣┗┻┐草草稂稂树树树树树树树树树树树树树树树树树树树树树树树树┫┫树树┫水水土道道道
石石石土土土─橋橋草草草草草草草草草草草草草草草草草砂砂砂砂砂砂砂砂砂砂砂砂水水┣稂稂═草草草草稂稂稂稂稂稂稂稂稂稂稂草草草草草草草草稂稂树土土┫┫土土─橋橋道道道土
石石石土土土─橋橋草草草草草草草草草草草草草草草草草砂砂砂砂砂砂砂砂砂砂砂砂水水┣稂稂═草草草草稂稂稂稂稂稂稂稂稂稂稂草草草草草草草草稂稂树土土──土土┫水水土土土土
石石石石石石┫水水石石石石石石石石石石石石草草草草草草草草草草草草草草草草草橋橋═草草═草草草草草草草草稂稂草草草草草草草稂稂稂稂草草草草土土土┫┫穴穴┫水水树树树土
石┌┻┻┻┻┛水水石石石石石石石石石石石石草草草草草草草草草草草草草草草草草橋橋═草草═草草草草草草草草稂稂草草草草草草草稂稂稂稂草草草草土土土┫┫┌┻┛水水树树树土
石┫水水水水水水水石石石石石石石石石石石石石石石石石石石石石石石石石石石石石水水┣草草┣┏┳┳┳┳┓草草草草草草┏┳┳┳┳┳┳┳┳┳┓草草草草草┫┫┫水水水水土土土土
┻┛水水水水水水水石石石石石石石石石石石石石石石石石石石石石石石石石石石石石水水┣草草┣┣穴穴穴穴┫草草草草草草═草草草草草草草草草─草草草草草┫┫┫水水水水土土土土
水水水水石石石石石石石石石石石石石石石石石石石石石石石石石石石石石石石石石石水水┣草草┣┗┐穴穴穴┳┳┳┳┳┳┳┳草草草草草草草草草┳┳┳┳┳┓┫┫┫水水花土土土树树
水水水水石石石石石石石石石石石石石石石石石石石石石石石石石石石石石石石石石石水水┣草草┗┐┣┏┳┳┳┳┳┳┳┳┳┳┳┳┳┳┳┳┓草草草┏┳┳┓┫┫┫┫水水土花土土树树
水水石石石石石石石石石石石石石石石石石石石石石石石石石石石石石石石石石石石石水水┗┻┻┐┣┣┣稂稂稂稂稂稂稂稂稂稂稂稂稂草草草─草草草┣稂稂┫┫┫┫┫水水水水土土土土
水水石石石石石石石石石石石石石石石石石石石石石石石石石石石石石石石石石石石石水水水水水┣┣┣┣稂稂稂稂稂稂稂草草稂稂草草草草草┳┳┳┳┳稂稂┫┫┫┫┫水水水水土土土土
水水石石石石石石石石石石石石石石石石石石石石石石石石石石石石石石石石石石石石水水水水水┣┣┣┣稂稂稂稂稂稂草草草草飾飾飾飾草草稂稂稂稂稂稂稂┫┫┫┫┳┳┓水水┏┳┳┳
水水石石石石石石石石石石石石石石石石石石石石石石石石石石石石石石石石石石石石石石石水水┣┣┣┣稂稂稂稂稂稂稂草草草無门無無草草稂稂稂稂稂稂稂┫┫┫┳┳┓┫水水┣┏┳┳