草草树树树树树树树树树树道道道道道道道道橋橋道道道道道道道道橋橋道道道道道道道道道土土土穴穴穴穴石石石树树树树树树树树树树树树树树树树树树┏┲┳┳┳┣┣穴穴穴穴穴穴穴穴┫┫畑畑畑社畑畑畑树树树树
草草树树树树树树树树树树道道道道道道道道橋橋道道道道道道道道橋橋道道土土土土树土土树树树树树树树树树树树树树树树树树树树树树树树树树树树┏┲┳穴穴穴┣┣┏┳┳┳┓穴穴┌┛┫畑畑畑畑畑畑畑树树树树
草草草草树树树树树树树树道道树树树树树树水水土土土土土土土土水水道道土树土土土土土树树树树树树树树树树树树树树树树树树树树树树树树树树┏┲┳穴穴穴穴┣┣┣穴穴穴┫穴┌┛┌┛畑畑畑畑畑畑畑树树树树
草草草草树树树树树树树树道道树树树树树树水水土土土土土土土土水水道道土土土土土土树树树树树树树树树树树树树树树树树树树树树树树树树树┏┲┳穴穴穴穴┏┳┳┣穴穴穴┫┌┛┌┛树畑畑畑畑畑畑畑飾飾飾飾
土土土土树树树树树树树树道道树树树树树树水水水水水水水水水水水水土土树树树树树树树树树树树树树树树树树树树树树树树树树树树树树树树树┣┣穴穴穴穴穴┣┏┳┳穴穴穴┫┫┌┛树树畑畑畑畑畑畑畑無门無無
土土土土树树树树树树树树道道树树树树树树水水水水水水水水水水水水土土树树树树树树树树树树树树树树树树树树树树树树树树树树树树树树树树┣┣穴穴穴┏┳┳┣穴穴穴┌┻┛┫┫树树树畑畑畑畑畑畑畑土土土土
道道道道道道道道道道道道道道树树树树树树树树树树树树树树树树树树土土树树树树树树树树树树树树树树树树树树树树树树树树树树树树树树树树┣┣穴┏┳┳┏┳┳穴穴┌┛┌入┛┫树草草畑畑畑畑畑畑畑土土土土
道道道道道道道道道道道道道道树树树树树树树树树树树树树树树树树树土土树树树树树树树树树树树树树树树树树树树树树树树树树树树树树树树树┣┣穴┣┏┳┳穴穴┌┻┛┌┛穴┌┛树草树树树树树树树树土土土土
土道道土土土树树树树树树树树树树树树树树树树树树树树树树树树树树土草树树树树树树树树树树树树树树稂树草树树树树树树树树树树树树树┏┲┳┳穴┣┣穴穴穴┌┛┌┻┛穴穴┫树树草树树树树树树树树土土土土
土道道土土土树树树树树树树树树树树树树树树树树树树树树树树树树树草土树树树树树树树稂稂树草草稂稂稂草树树树树树树树树树树树树树┏┲┳穴穴穴┣┗┻┻┻┛┌┛穴穴穴┌┛树树草草草树树树树树树树树土土
土道道土土土树树树树树树树树树树树树树树树树树树树树树树树树草稂草草草稂草草稂稂树稂稂稂稂稂稂树草树树树树树树树树树树树树树树┣┣穴穴穴穴┗┻┻┻┛┌┛穴穴┌║┛土花树水水草树树树树树树树树树树
土道道土土土树树树树树树树树树树树树树树树树树树树树树树树树草草土树草草草稂稂树草草树草稂稂稂稂稂树树树树树树树树树树树树树┏┲┳穴穴┌┻┻┻┻┻入┛穴穴┌┛土土土土土水水草树树树树树树树树树树
草道道土土土树树树树树树树树树树树树树树树树树树树树树树树草草树草草草草稂稂草草草草稂稂树树稂稂稂稂稂树树树树树树树树树树树┣┣穴穴穴┫┌┻┻┻┐穴穴穴┌┛李土树土李土草草草树树树树树树树树树树
草道道土土土树树树树树树树树树树树树树树树树树树树树树树草草草草草土草树稂草草树稂稂稂草树草稂草树草草树树树树树树树树树树┏┲┳穴穴穴┫┫树树树┗┻┻┻┛树树土土土树土树树树树树树树树树树树树树
草道道土土土树树树树树树树树树树树树树树树树树树树树树树草草树草草树草草稂树稂树草草树草草稂稂草草稂稂稂稂树树树树树树树┏┲┳穴穴穴穴┫┫树树树树树树树树树树树树土土树树树树树树树树树树树树树树
草草草草草草草树树树树树树树树树树树树树树树树树树树草草草草树草草草稂稂稂稂树稂稂稂稂稂稂稂稂树稂树树草树树树树树树树┏┲┳穴穴穴穴穴┳┳┱┓树树树树树树树树树树树树树树树树树树树树树树树树树树
草草草草草草草树树树树树树树树树树树树树树树树树草草草树草草草草树稂稂树稂草树草草草树草草树稂树稂树稂草草树树树┏┲┳┳┳穴穴穴穴穴穴穴穴┳┱┓树树树树树树树树树树树树树树树树树树树树树树树树树
草草草草草草草树树树树树树树树树树树树树树树树稂稂树草草树草稂稂稂稂稂草草草草稂树稂稂稂稂草树草草草稂树树树┏┲┳┳穴穴穴穴穴穴穴穴穴穴穴穴┳┱┓树树树树树树树树树树树树树树树树树树树树树树树树
土道道草草草草树树树树树树树树树树树树树树树稂稂稂稂树草稂稂稂稂草树稂树稂稂稂稂草草稂草树树稂草树草稂稂树┏┳┣穴穴穴穴穴穴穴穴穴穴穴穴穴穴穴┫┫树树树树树树树树树树树树树树树树树树树树树树树树
土道道草草草草树树树树树树树树树树树树树树稂稂稂树树稂树稂树稂稂稂草草草草草树草树稂草树草草草土树草树树┏┳穴┗┻┻┻┐穴穴穴穴穴穴穴穴穴穴穴┫┫树树树树树树树树树树树树树树树树树树树树树树树树
飾道道草草草草树树树树树树树树树树树树树稂稂稂树稂稂稂稂稂稂稂草草稂稂稂稂树树树树树树树树土树草草稂稂稂┗入┻┻┻┻┐┗┻┐穴穴穴穴穴┌┻┻┻┛┫树树树树树树树树树树树树树树树树树树树树树树稂树
飾道道树树树树树树树树树树树树树树树树树稂树树稂树树稂树树树树草树草树草树树花土花李花李土土土树草草树稂稂稂树树树树┗┻┐┣穴穴穴穴┌┛┌┻┻入┛树树树树畑畑畑土畑畑畑树树树树树树树树树树树稂稂
無道道树树树树树树树树树树树树树树树树树树稂稂稂稂稂树稂草草草树草树草树草草树土飾飾飾飾土果土树树树树树树树树树树树树树┣┗┐穴穴穴┫┌┛树土土土土土土树畑畑畑土畑畑畑树树树树树树树树树树树树稂
無道道树树树树树树树树树树树树树树树树树稂树稂稂稂树稂稂草草树草树草树草草树李土無门無無土土土树树树树树树树树树树树树树┗┐┣穴穴┌┛┫树树土土土土果土树畑畑畑土畑畑畑树树树树树树树树树树树稂稂
道道道树树树树树树树树树树树树树树树稂稂稂稂稂树稂稂稂稂树草草稂树草稂稂树草水道道道水水水树树树树树树树树树树树树树树树树┣┣穴┌┛┌┛树稂土土土土土土土土土土土土土土树树树树树树树树树稂稂稂树
道道道树树树树树树树树树树树树树稂稂稂树稂树树树树树树稂稂稂树草草稂树草草稂水水水土水水水树树树树树树树树树树树树树树树树┣┗┻┛┌┛树稂稂土飾飾飾飾土树畑畑畑土畑畑畑树树树树树树树树树树稂树稂
飾飾飾飾树树树树树树树树树树树树稂树草草树稂草草稂草草树树稂稂稂树草草草草草稂树树土草水水树树树树树树树树树树树树树树树树┗┐穴┌┛树树稂草土無门無無土树畑畑畑土畑畑畑树树树树树树树树树树树稂稂
飾飾飾飾树树树树树树树树树树稂树稂稂树树草草稂树草树草草稂树树树稂树草稂树草稂树稂草树水水树树树树树树树树树树树树树树树树树┣┌┛树树树树草土土土土土土树畑畑畑土畑畑畑树树树树树树树树树树树稂树
無無無無树树树树树树树树树树稂稂稂树草稂草树稂草草稂草草草稂草草稂稂树草草草树稂树稂稂水水树树树树树树树树树树树树树树树树树┗┛树树树树树草土土水土草草树树树树树树树树树树树树树树树树树树稂稂稂
無门買無树树树树树树树树树树树稂树稂草树草草稂树草树草草草稂稂树草树稂稂树草草草树草树水水树树树树树树树树树树树树树树树树树树树树树树树树稂草水水土稂稂树树树树树树树树树树树树树树树树稂稂稂树稂
道道道道道道树树树树树树树树稂稂树稂树草草稂树草草稂草草树稂草草草稂树草树草树草草草草水水树树树树树树树树树树树树树树树树树树树树树树树树稂草水土土稂树树树树树树树树树树树树树树树树树稂树树树树
道道道道道道树树树树树树树稂树草稂稂草草树稂草草树稂草树草稂树草草草树稂草稂草稂树稂树水水草草草草草草树树树树树树树树树树树树树树树树树树稂水水草草树树树树树树树树树树树树树树树树树树树树树树树
飾飾土土道道树树树树树树稂草草树稂树草稂稂树草树稂草树草草草稂草稂树稂树草草树草草树树水水草草草草草草草树树树树树树树树树树树树树树树树树水水稂稂树树树树树树树树树树树树树树树树树树树树树树树树
無無土土道道树树树树草草稂树草稂稂草草树草草草草树稂草树水树稂树草草草树树树树树树树草水水草草草草草草草树树树树树树树树树树树树树树树树水水水稂树树树树树树树树树树树树树树树树树树树树树树树树树
土土土土道道树树草草草稂草草草树稂草草稂草树草草草稂树草水水稂草稂草稂稂土土土土土土土橋橋土土土土草草草树树树树树树树树树树树树树树树水水树树树树树树树树树树树树树树树树树树树树树树树树树树树树
土土土土道道树树草草草草草草草草草树草稂树草水水稂稂稂树树水草稂稂树草树土土土土土土土橋橋土土土土草草草树树树树树树树树树树树树水水水水树树树树树树树树树树树树树树树树树树树树树树树树树树树树树
道道道道道道土土土土土土土土土土土土土土土土土水水水稂稂水水稂树草稂稂稂土土草草草草草水水草树土土草树树树树树树树树树树树树水水水水树树树树树树树树树树树树树树树树树树树树树树树树树树树树树树树
道道道道道道土土土土土土土土土土土土土土土土土水水水树树水树稂稂稂稂树稂土土草树草草草水水草草土土草树树树树树树树树树树树水水水树树树树树树树树树树树树树树树树树树树树树树树树树树树树树树树树树
水水土土道道树树草草草草草草草草草草草草草土土树树水水水水树草草树稂稂稂土土草草草树树水水树草土土草树树树树树树树树树树水水树树树树树树树树树树畑畑畑社畑畑畑树树树树树树树树树树树树树树树树树树
水水土土道道树树草草草草草草草草草草草草草土土树树水稂树树树草草稂稂树稂土土草草树树树水水树树土土草树树树树树树树树树水水水树树树树树树树树树树畑畑畑畑畑畑畑树树树树树树树树树树树树树树树树树树
水水水水道道树树树树树树树树树树树树树树树土土土草稂水草土土土土土稂稂稂土土草树树树树水水水水圯圯水水水水水水水水水水水树树树树树树树树树树树树畑畑畑畑畑畑畑树树树树树树树树树树树树树树树树水水
水水水水道道树树树树树树树树树树树树树树树土土草草水稂稂水草土土土稂水水圯圯水水水水水水水水水圯圯水水水水水水水水水水树树树树树树树树树树树树树畑畑畑畑畑畑畑树树树树树树树树树树树树树树树树水水
土土水水道道树树树树树树树树树树树树树树树树树水水水水水水水水圯圯水水水圯圯水水水水水水水水水圯圯水水水水水水水树树树树树树树树树树树树树树树树畑畑畑畑畑畑畑树树树树树树树树树树树树树树树树水水
土土水水道道树树树树树树树树树树树树树水水水水水水水水水水水水圯圯水水水圯圯水水水水水树树树树土土树树树树树树树树树树树树树树树树树树树树树树树畑畑畑畑畑畑畑树树树树树树树树树树树树树树树树水水
土土水水道道树树树树树树树树树树树树水水水水水水水水水水水水水圯圯水水树土土树树树树树树树树树土土树树树树树树树树树树树树树树树树树树树树树树树畑畑畑畑畑畑畑树树树树树树树树树树树树树树树树水水
飾土水水道道树树树树树树树树树树树树水水水水水水水水树树树树树土土土土土土土树树树树树树树树树土土草草草草草草草草草草草稂树稂稂稂树稂稂树树树树飾飾飾飾土树树树树树树树树树树树树树树树树树树水水
無土水水道道树树树树树树树树树树树树水水水树树树树树树树树树树土土土土土土土树树树树树树树树树土土草草草草草草草草草草草稂稂稂稂稂稂稂稂稂稂树树無门無無土树树树树树树树树树树树树树树树树树水水水
無土水水道道树树树树树水水水水水水水水水树树树树树树树树树树树树树树树树树树树树树树树树树树树树树树树树树树草草草树草草树稂树稂草草草草草草草土土土土土土树树树树树树树树树树树树树树树树土水水水
道道橋橋道道树树树树水水水水水水水水水水树树树树树树树树树树树树树树树树树树树树树树树树树树树树树树树树树草草树草草草草稂稂稂稂草草草草草草草土土土土土树树树树树树树树土土土土土土土土土土橋橋道
道道橋橋道道树树树水水水水水┏┳┳┳┳┳┳┳┓树树树树树树树树树树树树树树树树树树树树树树树树树树树树树树草草草草树草草稂树稂稂草草树稂稂稂稂土土土土土树树树树树树树树土土土土土土土土土土橋橋道
水水水水圯圯水水水水水水水┏┳┏┳┳┳┳┓穴┱┱┓树树树树树树树树树树树树树树树树树树树树树树树树树树树树草草草草草草草稂稂稂树草草稂稂树稂稂树树树草草树树树树树树树树土土树树树草草土土水水水道
水水水水圯圯水水水水水┏┲┲┏┳穴飾穴穴┫穴┫┫┫树树树树树┏┲┱│┳┓树树树树树树树树树树树树树树树树树树树草草草草草稂稂树树草草树稂稂树树树树树草草树树树树树树树树土土树树树树草土土水水水道
水水水水土树树水树树树┣┣┣┣穴飾飾飾穴┫穴┫┫┫树树树树树┣┗┛穴穴┫树树树树树树树树树树树树树树树树树树树树树树草草草草草草草草稂稂稂树树树树树草草树树树树树树树树土土树树树树草土土水水水道
水水水水土树土水树树树┣┣┣┣飾飾飾飾飾┫穴┫┫┫树树树树树═穴穴穴水水树树树树树树树树树树树树树树树树树树树树树树草草草草草草草草稂树树树树树树树草草稂稂稂稂树树树树土土树树树树草土土水水水道
水水水水土土土水树树树┣┣┣┣無無無無無┫┌┛┫┫树树树树树┣┏┓穴穴─树树树树树树树树树树树树树树树树树树树树树树树树树树树树树树树树树树树树树树草草稂稂树稂稂稂稂树土土树树树树草土土水水水道
水水水水水土树树水树树┣┣┣┣無無门無無┫┫┌┛┫树树树树树┣┗┛穴穴┫树树树树树树树树树树树树树树树树树树树树树树树树树树树树树树树树树树树树树树草草稂稂稂树稂稂树稂草草树树树树草土土水水水花
水水水水土土树水水树树┣┣┣┗┻┻║┻┻┛┫┫┌┛树树树树树┗┻┻║┻┛树树树树树树树树树树树树树树树树树树树树树树树树树树树树树树树树树树树树树树草草稂稂树稂稂稂稂稂草草树树树树草土土水水水土
树树草草土草水树树树树┣┣┗┻┻┻║┻┻┻┛┫┫树树树树树树树树树树树树树树树树树树树树树树树树树树树树树树树树树树树树树树树树树树树树树树树树树树草草稂稂稂稂稂稂稂稂草草树树树树草土土水水水花
水草土稂稂稂水水水水树┣┗┻┻┻┻║┻┻┻┻┛┫树树树树树树树树树树树树树树树树树树树树树树树树树树树树树树树树树树树树树树树树树树树树树树树树树树草草草草草草草草草草草草树树树树树土土水水水土
草土水水稂稂水树树水树┗┻┻┻┻┻║┻┻┻┻┻┛树树树树树树树树树树树树树树树树树树树树树树树树树树树树树树树树树树树树树树树树树树树树树树树树树树草草草草草草草草草草草草树树树树树土土水水水土
草树树稂水树水水水水树树树树树树树草稂树树树树树树树树树树树树树树树树树树树树树树树树树树树树树树树树树树树树树树树树树树树树树树树树树树树树树树树树树树树树树树树树树树树树树树树树土土水水飾飾
土水稂草水水水树水树水树树树树树树草草草草树树树树树树树树树树树树树树树树树树树树树树树树树树树树树树树树树树树树树树树树树树树树树树树树树树树树树树树树树树树树树树树树树树树树树树土土水水無门
土稂水水树水水树树水水树树树树树树树稂树稂草树树树树树树树树树树树树树树树树树树树树树树树树树树树树树树树树树树树树树树树树树树树树树树树树树树树树树树树树树树树树树树树树树树树树树土土水水水道
水稂稂稂草草草树树水水树树树树树树树树树稂草树树树树树树树树树树树树树树树树树树树树树树树树树树树树树树树树树树树树树树树树树树树树树树树树树树树树树树树树树树树树树树树树树树树树树土土水水水水
稂树水水稂草水树树水水树树树树树树树树草稂稂树树树树树树树树树树树树树树树树树树树树树树树树树树树树树树树树树树树树树树树树树树树树树树树树树树树树树树树树树树树树树树树树树树树树树土土草水水水
