石石石石石石石石石石石石石石石石石石石
石石石石石石石石石石石石石石石石石石石
石石石石石石石石石石石石石石石石石石石
石石石石石石石石石石石石石入石石石石石
石石石石石石石石石石石石穴穴石石石石石
石石石石石石石石石石石岩穴穴石石石石石
石石石石石湿湿湿石石岩穴穴岩石石石石石
石石石石石湿湿湿湿湿穴穴穴石石石石石石
石石石石石石石湿湿湿穴穴穴石石石石石石
石石石石石穴穴穴穴石石岩穴石石石石石石
石石石石石穴岩岩穴穴穴穴穴石石石石石石
石石石石石穴穴岩岩穴穴岩岩石石石石石石
石石石石石石穴石石石石石石石石石石石石
無無無無無無入無無無無無無無無無無無無
無無無無無無無無無無無無無無無無無無無
無無無無無無無無無無無無無無無無無無無
無無無無無無無無無無無無無無無無無無無
無無無無無無無無無無無無無無無無無無無