树树树树树树树树树树树树树树树树树树树树树树树树树石石石石石石石石石石
树树树树树树树树树树树树树树树树树树树树树树树树树树石石石石石石石石石
树树树树树树树树树树树树树树树树树树树树树树树树树树树石石石石石石石石
树树树树树树树树树树树树树树树树树树树树树树树树树树树树石石石石石石石
树树树树树树树树树土土土土土土草草草草树树树树树树树树树树石石石石石石
树树树树树树树树土土飾飾飾飾土草草草草树树树树树树树树树树树石石石石石
树树树树树树树树土土無门無無土土土土土土土树树树树树树树树树树石石石石
树树树树树树树树花土土土土土土果土土土土土土树树树树树树树树树树树石石
树树树树树树树土土花土土土土土土土土土土李李树树树树树树树树树树树树石
树树树树树树树土土土土土土土土土土土土李李水水水树树树树树树树树树树石
树树树树树树树草草草草土土土土土土水水水水水水水水树树树树树树树树树石
树树树树树树树草草草草草草草草草草水水水水水水水水水水树树树树树树树树
树树树树树树树草草草草草草草草草草水水水水水水水水水水水水水水水水水水
树树树树树树树草草草草草草草草草水水水水水水水水水水水水水水水水树树树
石树树树树树树树草草草草草草草草水水水水水水水水水水水水水水水水水树树
石树树树树树树树草草草草草草草草水水水水水水水水水水水水水水水水水水树
石树树树树树树树草草草草草草草草水水水水水水水水水水水水水水水水水水树
石树树树树树树树草草草草草草草草草水水水水水水水水水水水水水水水水水树
石树树树树树树树树草草草草草草草草水水水水水水水水水水水水水水水水树树
石树树树树树树树树草草草草草草草草草水水水水水水水水水水水水水水水树树
石树树树树树树树树树草草草草草草草草草草水水水水水水水水水水水水树树树
石石石树树树树树树树草草草草草草草草草草水水水水水水水水水水水树树树树
石石石树树树树树树树树草草草草草草草草草草水水水水水水水水水树树树树树
石石石树树树树树树树树树草草草草草草草草草水水水水水水水水树树树树树石
石石石树树树树树树树树树树树草草草草草草草草水水水水水树水水树树树树石
石石石石石树树树树树树树树树树树草草草草草草水水水水树树树水树树树树石
石石石石石树树树树树树树树树树树树草草草草草草树水水树树树水水树树石石
石石石石石石石树树树树树树树树树树草草草草草树树水水树树树树水水石石石
石石石石石石石树树树树树树树树树树树草草草树树石水水树树石石石水水石石
石石石石石石石石石石石石树树树树树树草草草石石石水水石石石石石石水水石
石石石石石石石石石石石石树树树树树树石入石石石石水水石石石石石石石水水
石石石石石石石石石石石石石石石石石石石石石石石石水水石石石石石石石石石
石石石石石石石石石石石石石石石石石石石石石石石石水水石石石石石石石石石
石石石石石石石石石石石石石石石石石石石石石水水水水水石石石石石石石石石
石石石石石石石石石石石石石石石石石石石石石水水水水水石石石石石石石石石