树树树树树树树树树树树树树树树树树树树树树树树树树树树树树树树树树树树
树树树树树树树树树树树树树树树树树树树树树树树树树树树树树树树树树树树
树树树树树树树树树树树树树树树树树树树树树树树树树树树树树树树树树树树
树树树树树树树树树树树树树树树树树树树树树树树树树树树树树树树树树树树
树树树树树树树树树土土土土土土草草草草树树树树树树树树树树树树树树树树
树树树树树树树树土土飾飾飾飾土草草草草树树树树树树树树树树树树树树树树
树树树树树树树树土土無门無無土土土土土土土树树树树树树树树树树树树树树
树树树树树树树树花土土土土土土果土土土土土土树树树树树树树树树树树树树
树树树树树树树土土花土土土土土土土土土土李李树树树树树树树树树树树树树
树树树树树树树土土土土土土土土土土土土李李水水水树树树树树树树树树树树
树树树树树树树草草草草土土土土土土水水水水水水水水树树树树树树树树树树
树树树树树树树草草草草草草草草草草水水水水水水水水水水树树树树树树树树
树树树树树树树草草草草草草草草草草水水水水水水水水水水水水水树树树树树
树树树树树树树草草草草草草草草草水水水水水水水水水水水水水水水水树树树
树树树树树树树树草草草草草草草草水水水水水水水水水水水水水水水水水树树
树树树树树树树树草草草草草草草草水水水水水水水水水水水水水水水水水水树
树树树树树树树树草草草草草草草草水水水水水水水水水水水水水水水水水水树
树树树树树树树树草草草草草草草草草水水水水水水水水水水水水水水水水水树
树树树树树树树树树草草草草草草草草水水水水水水水水水水水水水水水水树树
树树树树树树树树树草草草草草草草草草水水水水水水水水水水水水水水水树树
树树树树树树树树树树草草草草草草草草草草水水水水水水水水水水水水树树树
树树树树树树树树树树草草草草草草草草草草水水水水水水水水水水水树树树树
树树树树树树树树树树树草草草草草草草草草草水水水水水水水水水树树树树树
树树树树树树树树树树树树草草草草草草草草草水水水水水水水树树树树树树树
树树树树树树树树树树树树树树草草草草草草草草水水水水水树树树树树树树树
树树树树树树树树树树树树树树树树草草草草草草水水树树树树树树树树树树树
树树树树树树树树树树树树树树树树树草草草草草草树树树树树树树树树树树树
树树树树树树树树树树树树树树树树树草草草草草树树树树树树树树树树树树树
石石树树树树树树树石树树树树树树树树草草草树树石石树树树树树树树树石石
石石石石石石石石石石石石树树树树树树草草草石石石石石石石石石石石石石石
石石石石石石石石石石石石石石石树树树石入石石石石石石石石石石石石石石石
石石石石石石石石石石石石石石石石石石石石石石石石石石石石石石石石石石石
石石石石石石石石石石石石石石石石石石石石石石石石石石石石石石石石石石石
石石石石石石石石石石石石石石石石石石石石石石石石石石石石石石石石石石石
石石石石石石石石石石石石石石石石石石石石石石石石石石石石石石石石石石石