無無無無無無無無無無無無無無無
無無無無無無無無無無無無無無無
無無無無無無無無無無無無無無無
無無無無無無無無無無無無無無無
無無無無無無無無無無無無無無無
無無無無無無無無無無無無無無無
無無無無無無無無無無無無無無無
無無無無無無無無無無道道道無無
無無無無無無無無無無道道道無無
無無道道道道道道道無道道道無無
無無道道道道道道道無道道道無無
無無道道道道道道道無道道道無無
無無道道道道道道道道道道道無無
無無無無無土無無無無無無無無無
無無無無無無無無無無無無無無無