┫┌┻┻┻┻┻┻┻┻┻┻┻┻┻┻┻┐┣
┫┫┌┻┻┻┻┻┻┻┻┻┻┻┻┻┐┣┣
┫┫┫┌┻┻┻┻┻┻┻┻┻┻┻┐┣┣┣
┫┫┫┫穴穴穴穴湿湿湿┌┻入┐┣┣┣┣
┫┫┫┫穴穴穴穴湿湿湿┫穴穴┣┣┣┣┣
┫┫┫┫┌┻┻┻┐穴┌┛穴穴┣┣┣┣┣
┫┫┫┫┫湿湿湿┗┻┛穴穴┏┣┣┣┣┣
┫┫┫┫┫湿湿湿湿湿穴穴穴┣穴┣┣┣┣
┫┫┫┫┫湿湿湿湿湿┏┓穴┣穴┣┣┣┣
┫┫┫┫┫湿穴穴穴穴┗┛穴┣穴┣┣┣┣
┫┫┫┫┫穴穴┏┓穴穴穴穴┣穴┣┣┣┣
┫┫┫┫┫穴岩┣┫穴穴┏┳┳穴┣┣┣┣
┫┫┫┫┫穴穴┣┳┳┳┳穴穴穴┣┣┣┣
┳┳┳┳┳┳u┳┳┳┳┳┳┳┳┳┳┳┳
┳┳┳┳┳┳┳┳┳┳┳┳┳┳┳┳┳┳┳
┳┳┳┳┳┳┳┳┳┳┳┳┳┳┳┳┳┳┳
┳┳┳┳┳┳┳┳┳┳┳┳┳┳┳┳┳┳┳
┳┳┳┳┳┳┳┳┳┳┳┳┳┳┳┳┳┳┳