树树树树树树树树树树树树树树树树树树树树飾飾飾飾草┗┐┗┐┗┐┗┐┗┐
树树树树树树树树树树树树树树树树树树树树無门無無草树┗┐┗┐┗┐┗┐┗
树树树树树树树树树树树树树树树树树树树树李土土土土土土┗┐┗┐┗┐┗┐
树树树树树树树树树树树树树树树树树树树树树畑畑畑畑畑土土┗┐┗┐┗┐┗
树树树树树树树树树土土土土土土草草草草树树畑畑社畑畑土土土┗┐┗┐┗┻
树树树树树树树树土土飾飾飾飾土草草草草树树畑畑畑畑畑草草土土┗┐┗┻┐
树树树树树树树树土土無门無無土土土土土土树树树树树树草草草草草┗┐穴┗
树树树树树树树树花土土土土土土果土土土土土土土树树树树树树草草草═穴穴
树树树树树树树土土花土土土土土土土土土土李李土土树树树树树土土土┣穴穴
树树树树树树树土土土土土土土土土土土土李李水水土土土土树树树草土┣穴穴
树树树树树树树草草草草土土土土土土水水水水水水水土坑土树树树树树┗┻┻
树树树树树树树草草草草草草草草草草水水水水水水水土土土树树树飾飾飾飾土
树树树树树树树草草草草草草草草草草水水水水水水水水水水水水水無门無無土
树树树树树树树草草草草草草草草草水水水水水水水水水水水水水水李土土土土
┓树树树树树树树草草草草草草草草水水水水水水水水水水水水草草草草土土土
┫树树树树树树树草草草草草草草草水水水水水水水水水水水草草稂稂草水水土
┫树树树树树树树草草草草草草草草水水水水水水水水水水水水水稂稂稂水水圯
┫树树树树树树树草草草草草草草草草水水水水水水水水水水水水水草水水水圯
┫树树树树树树树树草草草草草草草草水水水水水水水水水水水水水水水水树土
┫树树树树树树树树草草草草草草草草草水水水水水水水水水水水水水水水树土
┫树树树树树树树树树草草草草草草草草草草水水水水水水水水水水水水土树树
┳┳┓树树树树树树树草草草草草草草草草草水水水水水水水水水水水土土树树
┳┓┫树树树树树树树树草草草草草草草草草草水水水水水水水水水土土土树树
┓┫┫树树树树树树树树树草草草草草草草草草水水水水水水水水土土土树树┏
┫┫┫树树树树树树树树树树树草草草草草草草草水水水水水树水水土树树树┣
┫┫┳┳┓树树树树树树树树树树树草草草草草草水水水水草树树水土树树树┣
┫┳┳┓┫树树树树树树树树树树树树草草草草草草草橋橋草树树水水树树┏┳
┳┓穴┫┳┳┓树树树树树树树树树树草草草草草树树水水草树树树水水树┣穴
┓┫穴┳┳┓┫树树树树树树树树树树树草草草树树树水水树树┏┳┓水水┗┐
┫┫穴穴穴┫┳┳┳┳┳┓树树树树树树草草草树树树水水┏┳┳树┳┓水水┗
┫┫穴穴穴┳┳┳┳┳┓┫树树树树树树┏u┓树树树水水┣树树树树┳┓水水
┫┫穴穴穴穴穴穴穴穴┫┳┳┳┳┳┳┳┳穴┫树树树水水┣树树树树树┳┳┳
┛┫穴穴穴穴穴穴穴穴┳┳┳┳┳┳┳┳┳┓┫树树树水水┣树树树树树树树树
┻┛穴穴穴穴穴穴穴穴穴穴穴穴穴穴穴穴穴┫┫水水水水水┣树树树树树树树树
┻┻┻┻┻┻┻┻┻┻┻┻┻┻┻┐穴穴穴┫┫水水水水水┣树树树树树树树树
