石石石石石石石石石石石石石石石石石石石石石草草草草草草草草道道土土树土土土土树道道土水土水华水土道道道道道道道道道道道土土土土土土土土土草草草
石石石石石石石石石石石石石石石石石石石石石草草草草草草草草道道土土树树土树土土土道土水土土水水土道道道道道道道道道道道土土土土土土土土土草草草
石石石石石石石石石石石石石石石石石树树草草草草土土土土道道道道树树树树树花土花土道土水水水水水土道土土树树树树树树树树树树树树树树树树树土土树
石石石石石石石石石石石石石石石石石树树草草草草土土土土道道道道树树树树土土花土花道土土土土土土土道土树树树树树树树树树树树树树树树树树树土土树
石石石石石石石石石石石石石石石石石石石草草稂稂土土树树树树草草树树树树树飾飾飾飾道道道道道道道道道树树树树树树树树树树树树树树树树树树树草草草
石石石石石石石石石石石石石石石石石石石草草稂稂土土树树树树草草树树树树树飾飾飾飾道道道道飾飾飾飾树树树树树树树树树树树树树树树树树树树树草草草
石石石石石石石石石石石石石石石石石石石树树稂稂草草树树树树草草树树树树树無無無無道道道道飾飾飾飾树树树树树树树树树树树树树树树树树树树树树树土
石石石石石石石石石石石石石石石石石石石树树稂稂草草树树树树草草树树树树树無门買無道道道道無無無無树树树树树树树树树树树树树树树树树树树树树树土
石石石石石石石石石石石石水水水水石石石树树稂稂土土树树草草草草飾飾飾飾树土道道道道道道道無门館無树树树树树树树树树树树树树树树树树树树树树树土
石石石石石石石石石石水水水石石石石石石树树稂稂土土树树草草草草無门無無树土土土道道道道道道道树树树树树树飾飾飾飾树树树树树树树树树树树树树树土
石石石石石石石石水水水石石石石石石石石树树稂稂草草土土土土草草土土土树树树土土土土土道道道土树树水水树土無门無無树树树树树树树树树树树树树树树
石石石石石石石水水石石石石石石石入石石树树稂稂草草土土土土草草土花土土树树树花土土土道道土树树土水水土土土土土土树树树树树树树树树树树树树树树
石石石石石石水水石石石石石石石稂稂稂稂树树稂稂稂稂树树树树土土花土花土树树树树树树土道道树树树土水水土土土土土土树树树树树树树树树树树树树树树
嶝嶝嶝嶝嶝水水石石石石石石石石稂稂稂稂树树稂稂稂稂树树树树土土土花土树树树树树树树土道道树树土土水水土土树树树树树树树树树树树树树树树树树树树
飾嶝嶝水水水石石石石石石石石石树树稂稂树树树树稂稂树树树树树树树树树树树树树树树树土道道树树土土土土土土树树树树树树树树树树树树树树树树树树树
無水水水石石石石石石石石石石石树树稂稂树树树树稂稂树树树树树树树树树树树道道道道道道道道树树树草草草草草草树树树树树树树树树树树树树树树树树树
水水嶝嶝嶝嶝石石石石石石石石石石石稂稂稂稂稂稂稂稂树树树树树树树树树树树道道道道道道道道树树树树稂稂稂草土树树树树树树树树树树树树树树树树树树
嶝飾飾飾飾嶝石石石石石石石石石石石稂稂稂稂稂稂稂稂树树树树树树树树树树树道道草草草草草树树树树稂稂稂稂草草树树树树树树树树树树树树树树树树树树
嶝飾飾飾飾嶝嶝石石石石石石石石石石石石石石石石石石石石石石石石石石石树树無無無無無草草树树树树稂稂稂稂稂树树树树树树树树树树树树树树树树树树树
嶝無無無無嶝嶝嶝嶝石石石石石石石石石石石石石石石石石石石石石石石石石树树道道草草草草草树树树树树稂稂稂稂树树树树树树树树树树树树树树树树树树树
嶝無门無無嶝嶝嶝嶝嶝石石石石石入石石石石石石石石石石石石石石石石石石石石道道草草草草草草树树树树树树草稂树树树树树树树树树树树树树树树树树树树
道道道嶝嶝飾飾飾飾嶝嶝嶝嶝石石嶝石石石石石石石石石石石石石石石石石石石石道道草草草草草土土树树树树树草草树树树树树树树树树树树树树树树树树树树
飾嶝道嶝嶝無门無無道道嶝嶝嶝嶝嶝石石石石石石石石石石石石草草土土土土土土道道道道道道道土土树树树树树草草树树树树树树树树树树树树树树树树树树树
飾嶝道嶝嶝嶝道道道道嶝嶝嶝嶝石石石石石石石石石石石石石石草草土土土土土土道道道道道道道土土树树树树树草草树树树树树树树树树树树树树树树树树树树
無嶝道道道道道嶝嶝嶝嶝石石石石石石石石石石石石石石石石石土土草草石石石石石石石石石道道土土树树树树树草稂树树树树树树树树树树树树树树树树树树树
無嶝道嶝嶝嶝嶝嶝石石石石石石石石石石石石石石石石石石石石土土草草石稂稂草草草草土土道道土土树树树树树稂稂稂树树树树树树树树树树树树树树树树树树
道道道嶝嶝嶝石石石石石石石石石石石石石石石石石石石石石石土土石石石稂稂草草草草土土道道土土树树树树稂稂稂稂树树树树树树树树树树树树树树树树树树
嶝嶝嶝嶝嶝石石石石石石石石石石石石石石石石石石石石石石石土土石石石稂草草草道道道道道道土树树树树树稂稂稂稂树树树树树树树树树树树树树树树树树树
石石石石石石石石石石石石石石石石石石石石石石石石石石石石草土石石石稂草草草道道道道道道树树树树树树稂稂稂稂树树树树树树树树树树树树树树树树树树
石石石石石石石石石石石石石石石石石石石石石石石石石石石草土草石石石石石草草道道無無無無树树树树树树树稂稂稂树树树树树树树树树树树树树树树树树树
石石石石石石石石石石石石石石石石石石石石石石石石石石草草草稂石石石石石草草道道無土土土树树树树树树树草稂树树树树树树树树树树树树树树树树树树树
石石石石石石石石石石石石石石石石石石石石石石石石石草稂稂稂稂石石石石石石石道道無土草草無土土树树树树草草树树树树树树树树树树树树树树树树树树树
石石石石石石石石石石石石石石石石石石石石石石石石石稂稂稂稂稂稂石石石石石石道道土土草草土土土土土土土土草树树树树树树树树树树树树树树树树树树树
石石石石石石石石石石石石石石石石石石石石石石石石石稂稂稂稂草稂草石石石石石土土無土草草無土土土土树树树树树树树树树树树树树树树树树树树树树树树
石石石石石石石石石石石石石石石石石石石石石石石石石稂草稂草草草草草石石石土土土無土草草無土土土土树树树树树树树树树树树树树树树树树树树树树树树
石石石石石石石石石石石石石石石石石石石石石石石石石石石石石石石草草土土無土土土树土草草無土土土树树树树树树树树树树树树树树树树树树树树树树树树
石石石石石石石石石石石石石石石石石石石石石石石石石石石石石石石草草土土無土土土树树草草無無無無树树树树树树树树树树树树树树树树树树树树树树树树
石石石石石石石石石石石石石石石石石石石石石石石石石石石石石石石石石土土無土土土树树草草草草土土树树树树树树树树树树树树树树树树树树树树树树树树
石石石石石石石石石石石石石石石石石石石石石石石石石石石石石飾飾飾飾土土無土树土树树草草草草土土树树树树树树树树树树树树树树树树树树树树树树树树
石石石石石石石石石石石石石石石石石石石石石石石石石石石石石無门無無土土树树树土树树树树草草土土树树树树树树树树树树树树树树树树树树树树树树树树
石石石石石石石石石石石石石石石石石石石石石石石石石石石石石土土土土土土树树树土树树树树草草土树树树树树树树树树树树树树树树树树树树树树树树树树
石石石石石石石石石石石石石石石石石石石石石石石石石石石石石土土土土土土树树土土树树树树树土土树树树树树树树树树树树树树树树树树树树树树树树树树
石石石石石石石石石石石石石石石石石石石石石石石石石石石石石石石石石土土树树無树树树树土土土土树树树树树树树树树树树树树树树树树树树树树树树树树
石石石石石石石石石石石石石石石石石石石石石石石石石石石石石石石石石土土土树土树树树树土土土树树树树树树树树飾飾飾飾树树树树树树树树树树树树树树
石石石石石石石石石石石石石石石石石石石石石石石石石石石石石石石石石土土土土土树树土土土土树树树树树树树树树飾飾飾飾树树树树树树树树树树树树树树
石石石石石石石石石石石石石石石石石石石石石石石石石石石石石石石石土土土土土土土無土土土土土土树树树树树土土無無無無草草草树树树树树树树树树树树
石石石石石石石石石石石石石石石石石石石石石石石石石石石石石石石石土土土土土土土無土土土土土土树树树树树土土無门無無草草草树树树树树树树树树树树
石石石石石石石石石石石石石石石石石石石石石石石石石石石石石石石土土土土土土土土無土土土土土土树树树树树道道道道道土土草草树树树树树树树树树树树
石石石石石石石石石石石石石石石石石石石石石石石石石石石石石石石土土土土土土土土無土土土土土土道道道道道道道道道道土飾草草树树树树树树树树树树树
石石石石石石石石石石石石石石石石石石石石石石石石石石石石石石石土土土土無無無無树土土土土土土道道道道道道道道道道土土草草树树树树树树树树树树树
石石石石石石石石石石石石石石石石石石石石石石石石石石石石石石石土土土土無土土土树树土土土土土树树树树树道道道道道土土草草树树树树树树树树树树树
石石石石石石石石石石石石石石石石石石石石石石石石石石石石石石石道道道道土土土土树土土土土树树树树树树树树土土土土草草草草树树树树树树树树树树树
石石石石石石石石石石石石石石石石石石石石石石石石石石石石石石石道道道道土土土土树土土土树树树树树树树树树土土土土草草草草树树树树树树树树树树树
石石石石石石石石石石石石石石石石石石石石石石石石石石石石石石石道道土土無土土土树树草草树树树树树树树树树树树草草草草草草树树树树树树树树树树树
石石石石石石石石石石石石石石石石石石石石石石石石石石石石石石石道道土土無土土土树树草草树树树树树树树树树树树草草草草草草树树树树树树树树树树树
石石石石石石石石石石石石石石石石石石石石石石石石石石石石石石石道道树树树土土土树树草草草草树树树树树树树树树树树树树树树树树树树树树树树树树树
石石石石石石石石石石石石石石石石石石石石石石石石石石石石石石石道道树树树树土土树树草草草草树树树树树树树树树树树树树树树树树树树树树树树树树树
石石石石石石石石石石石石石石石石石石石石石石石石石石石石石石石土土树树树树土土土土草草土土树树树树树树树树树树树树树树树树树树树树树树树树树树
石石石石石石石石石石石石石石石石石石石石石石石石石石石石石石石土土树树树树土土土土草草土土树树树树树树树树树树树树树树树树树树树树树树树树树树
石石石石石石石石石石石石石石石石石石石石石石石石石石石石石石嶝土土草草草草草草土土树树稂稂稂稂树树树树树树树树树树树树树树树树树树树树树树树树
石石石石石石石石石石石石石石石石石石石石石石石石石石石石石嶝嶝土土草草草草草草土土树树稂稂稂稂树树树树树树树树树树树树树树树树树树树树树树树树
石石石石石石石石石石石石石石石石石石石石石石石石石石石石嶝嶝石草草草草草草草草土土草草稂稂稂稂树树树树树树树树树树树树树树树树树树树树树树树树
石石石石石石石石石石石石石石石石石石石石石石石石石石石石嶝石石草草草草草草草草土土草草稂稂稂稂树树树树树树树树树树树树树树树树树树树树树树树树
石石石石石石石石石石石石石石石石石石石石石石石石石石石嶝嶝石石草草草草草草草草土土树树稂稂稂稂树树树树树树树树树树树树树树树树树树树树树树树树
石石石石石石石石石石石石石石石石石石石石石石石石石石石嶝石石石無無無無無無無無土土树树稂稂稂稂树树树树树树树树树树树树树树树树树树树树树树树树
石石石石石石石石石石石石石石石石石石石石石石石石石石石嶝嶝石石石石草草草草草草土土树树树树树树树树树树树树树树树树树树树树树树树树树树树树树树
石石石石石石石石石石石石石石石石石石石石石石石石石石石石嶝石石石石草草草草草草土土树树树树树树树树树树树树树树树树树树树树树树树树树树树树树树
石石石石石石石石石石石石石石石石石石石石石石石石石石石嶝嶝石石石石草草草草草草土土树树树树树树树树树树树树树树树树树树树树树树树树树树树树树树
石石石石石石石石石石石石石石石石石石石石石石石石石石石嶝石石石石石草草草草草草土土树树树树树树树树树树树树树树树树树树树树树树树树树树树树树树
石石石石石石石石石石石石石石石石石石石石石石石石石石石嶝嶝嶝嶝嶝石石石草草草草土土树树树树树树树树树树树树树树树树树树树树树树树树树树树树树树
石石石石石石石石石石石石石石石石石石石石石石石石石石石嶝嶝岩嶝嶝嶝石石草草草草土土树树树树树树树树树树树树树树树树树树树树树树树树树树树树树树
石石石石石石石石石石石石石石石石石石石石石石石石石石石嶝嶝嶝嶝岩嶝石石草草土土土土树树树树树树树树树树树树树树树树树树树树树树树树树树树树树树
石石石石石石石石石石石石石石石石石石石石石石石石石石石嶝岩嶝嶝嶝嶝石石树树土土土土树树树树树树树树树树树树树树树树树树树树树树树树树树树树树树
石石石石石石石石石石石石石水水石石石石石石石石石石石石嶝嶝嶝嶝岩嶝石石树树土土草草草草树树树树树树树树树树树树树树树树树树树树树树树树树树树树
石石石石石石石石石石石石石水水石石石石石石石石石石石石嶝嶝岩嶝嶝嶝石石树树土土草草草草树树树树树树树树树树树树树树树树树树树树树树树树树树树树
石石石石石石石石石石石石石水水石石石石石石石石石石石石石嶝嶝嶝嶝石石石树树土土草草草草树树树树树树树树树树树树树树树树树树树树树树树树树树树树
石石石石石石石石石石石石石水水石石石石石石石石石石石石石石石石石石树树草草土土草草草草树树树树树树树树树树树树树树树树树树树树树树树树树树树树
石石石石石石石石石石石石石水水石石石石石石石石石石石石石石石石石石树树草草土土草草树树树树树树树树树树树树树树树树树树树树树树树树树树树树树树
石石石石石石石石石石石石石水水石石石石石树树树树树树树树树石石石石树树草草草草草草树树树树树树树树树树树树树树树树树树树树树树树树树树树树树树
石石石石石石石石石石石石石水水水石石树树树树树树树树树树树树树石石树树草草草草草草树树树树树树树树树树树树树树树树树树树树树树树树树树树树树树
石石石石石石石石石石石石石石滝滝石树树树树树土树树树树树树树树树树草草草草土土草草树树树树树树稂稂稂稂稂稂稂稂树树树树树树树树树树树树树树畑畑
石石石石石石石石石石石石石树水水树树树树树树土土树树树树树树树树树草草草草土土草草树树树树树树稂稂稂稂稂稂稂草草草树树树树树树树树树树树树畑畑
石石石石石石石石石石石石石树水水树树土树树树土土树树树树树草草土土土草草土土土树树树树树树树树稂稂稂稂稂稂稂草仏草稂稂稂稂稂树树树树树树树畑畑
石石石石石石石石石石石石石树水水水土土土土土土花树树树树树草草土土土草草土土土树树树树树树树树稂稂稂無稂稂稂草草草稂稂稂稂稂稂树树树树树树畑畑
石石石石石石石石石石石石石树水水水土土土土土花花树树树树树土土土土草草草草树树树树树树树树树树稂稂無無無稂稂稂稂稂稂稂稂稂稂稂稂树树树树树畑畑
石石石石石石石石石石石石石树树水水水土土土土树树树树树树树土土土土草草草草树树树树树树树树树树稂無無门無無稂稂稂稂稂稂稂稂稂稂稂树树树树树畑畑
石石石石石石石石石石石石石石石石水水水飾门飾飾树树树树树树树树道道树树树树树树树树树树树树树树稂稂稂稂稂稂稂稂稂稂稂稂稂無稂稂稂树树树树树畑畑
石石石石石石石石石石石石石石石石石水水飾飾飾飾树树树树树树树树道道树树树树树树树树树树树树树树稂稂稂稂稂稂稂稂稂稂稂稂無無無稂稂树树树树树畑畑
石石石石石石石石石石石石石石石石石水水無無無無树树花花飾飾飾飾道道树树树树树树树树树树树树树树稂稂稂稂稂稂稂稂稂稂稂無無门無無稂树树树树树畑畑
石石石石石石石石石石石石石石石石水水水無门無無树树土土飾飾飾飾道道树树树树树树树树树树树树树树稂稂稂稂稂稂稂稂稂稂稂稂稂稂稂稂稂树树树树树树树
石石石石石石石石树树树树树树树石水水水道道道道道道土土無無無無道道树树树树树树树树树树树树树树稂稂稂稂稂稂稂稂稂稂稂稂稂稂稂稂树树树树树树树树
石石石石石石石石树树树树树树树石水水土道道道道道道土土無门無無道道树树道道道道道道道道道树树树树树树树稂稂稂無稂稂稂树树树树树树草草草草草草草
草草草草草草稂稂树树土花花土土土橋橋道道道道道道道道道道道道道道道树树道道道道道道道道道树树树树树树树稂稂無無無稂稂树树树树树树草草草草草草草
草草草草草草稂稂树树土花花土土土橋橋道道道道道道道道道道道道道道道树树道道土土土李土道道土土草草树树树稂無無门無無稂树树树树树树草草树树树草草
稂稂稂稂草草草草土土土土石石石石水水飾飾飾飾道道道道道道道道道道道飾飾飾飾飾飾李土李道道土土草草树树树稂稂稂稂稂稂稂树树树树树树草草树树树草草
稂稂稂稂草草草草土土土土石石石石水水飾飾飾飾道道道道道道道道道道道飾飾飾飾飾飾土李土道道土土草草树树树树稂稂稂稂稂稂树树树树树树草草树树树草草
石石石石石石草草草草草草石石水水水水無無無無道道道飾飾飾飾飾飾土土無無無無無無李土李道道土土草草树树树树稂稂稂稂稂稂树树树树草草草草草草草草草
石石石石石石草草草草草草石石水水水水無门無無道道道飾飾飾飾飾飾土土無無门门無無土李土道道土土草草树树树树树树树稂稂树树树树树草草草草草草草草草
石石石石石石石石石石石石石石水水花土道道道道道道土無無無無無無土土土土道道树树树树树道道土土草草树树树树树树树稂稂树树树树树草草水水水水水水水
石石石石石石石石石石石石石石水水土花道道道道道道土無無门無無無土土土土道道树树树树树道道土土草草树树树树树树树稂稂树树树树树草草水水水水水水水
石石石石石石石石石石石石石石水水水水土土土土道道道道道道道道道道道道道道道树树树树树道道土土土土土土土树树草草草草草草草树树草草水水飾飾飾飾畑
石石石石石石石石石石石石石石水水水水土土土土道道道道道道道道道道道道道道道树树树树树道道土土土土土土土树树草草草草草草草树树草草水水無门無無畑
石石石石石石石石石石石石石石石石水水石石石石石石石树树树树树树树树树树树树树树树土土道道道道道道道土土树树道道道道道道道树树道道橋橋道道道道畑
石石石石石石石石石石石石石石石石水水石石石石石石石树树树树树树树树树树树树树树树土土道道道道道道道土土树树道道道道道道道树树道道橋橋道道道道畑
石石石石石石石石石石石石石石石石水水石石石石石石石树树树树树树树树树树树树树草草土土草草草草草道道土土树树道道树树树道道树树道道水水树树道道树
石石石石石石石石石石石石石石石石水水石石石石石石石树树树树树树树树树树树树树草草土土草草草草草道道土土树树道道稂稂稂道道树树道道水水树树道道树
石石石石石石石石石石石石石石石石水水石石石石石石石树树树树树树树树树树树树树草草土土树水水水水橋橋水水水水橋橋水水水橋橋水水橋橋水水树树道道树
石石石石石石石石石石石石石石石石水水石石岩石石石石石树树树树树树树树树树树树草草土土树水水水水橋橋水水水水橋橋水水水橋橋水水橋橋水水树树道道树
石石石石石石石石石石石石石石石石水水石石石石石石岩石树树树石石石石稂稂草草草草草土土树水水树树道道稂稂稂稂道道树树树道道道道道道树树树树土土土
石石石石石石石石石石石石石石石石水水石石石石岩石石石树树树石石石石稂稂草草草草草土土树水水树树道道树树树树道道树树树道道道道道道树树树树土土土
石石石石石石石石石穴穴穴穴穴穴穴橋橋穴穴穴穴穴穴穴穴土土土土土土土稂稂稂稂稂土土土土树水水树树道道道道道道道道树树树树树树树树树树树树树草草土
石石石石石石石石石穴穴穴穴穴穴穴橋橋穴穴穴穴穴穴穴穴土土土土土土土稂稂稂稂稂土土土土树水水树树道道道道道道道道树树树树树树树树树树树树树草草土
石石石石石石穴穴穴石石石石石石石水水石石石石石石石树树石石草草土土稂稂土土土土土水水水水水树树树树树树树树树树树树树树树树树树树树树树树草草土
石石石石石穴石石石石石石石石石石水水石石石石石石石树树石石草草土土稂稂土土土土土水水水水水树树树树树树树树树树树树树树树树树树树树树树树草草土
石石石穴穴石石石石石石水水水水水水水石石石石岩石石树树树树树树土土土土土土水水水水水树树树树树树树树树树树树树树树树树树树树树树树树树树草草土
石石穴石石石石石石石石水水水水水水水石石石石石石石树树树树土土土土土土土土水水水水水树树树树树树树树树树树树树树树树树树树树树树树树树树土土土
石穴石石石石石石石石石水水石石石石石石石石石石石石石石土土树树树树树水水水水水树树树树树树树树树树树树树树树树树树树树树树树树树树树树树土土土
穴石石石石石石石石石石水水石石石石石石石石石石石石石土树树树树树树树水水水水水树树树树树树树树树树树树树树树树树树树树树树树树树树树树树土土树
石石石石石石石石石石石水水石石石石石石石石石石石石石土树树树水水水水水水树树树树树树树树树树树树树树树树树树树树树树树树树树树树树树树树土土树