┫┫┫┌┻┻┻┻┻┻┻┻┻┐┣┣┣┣┣
┫┫┫┫┌┻┻┻┻┻┻┻┐┣┣┣┣┣┣
┫┫┫┫┫┌┻┻┻┻┻┐┣┣┣┣┣┣┣
┫┫┫┫┫┫┌┻┻┻┐┣┣┣┣┣┣┣┣
┫┫┫┫┫┫┫穴穴穴┣┣┣┣┣┣┣┣┣
┫┫┫┫┫┫┫穴穴穴┣┣┣┣┣┣┣┣┣
┫┫┫┫┫┫┫穴穴穴┣┣┣┣┣┣┣┣┣
┫┫┫┫┫┫┳┓穴┏┳┣┣┣┣┣┣┣┣
┫┫┫┫┫┳┓┫穴┣┏┳┣┣┣┣┣┣┣
┫┫┫┫┳┓┫┫穴┣┣┏┳┣┣┣┣┣┣
┫┫┫┳┓┫┫┫穴┣┣┣┏┳┣┣┣┣┣
┫┫┳┓┫┫┫┫穴┣┣┣┣┏┳┣┣┣┣
┫┫┓┫┫┫┫┫穴┣┣┣┣┣┏┳┣┣┣
┳┳┳┳┳┳┳┳u┳┳┳┳┳┳┳┳┳┳
┳┳┳┳┳┳┳┳┳┳┳┳┳┳┳┳┳┳┳
┳┳┳┳┳┳┳┳┳┳┳┳┳┳┳┳┳┳┳
┳┳┳┳┳┳┳┳┳┳┳┳┳┳┳┳┳┳┳
┳┳┳┳┳┳┳┳┳┳┳┳┳┳┳┳┳┳┳