石石石石石石石石石石石石石石石石石石石石石草草草草草草草草道道土土树树道道道道道土土花花土土道道道道道道道道道道道道道土道道道道道道道道道道道
石石石石石石石石石石石石石石石石石石石石石草草草草草草草草道道土土树树道道道道道花花土土花花道道道道道道道道道道道道道土道道道道道道道道道道道
石石石石石石石石石石石石石石石石石石石草草草草土土土土道道道道树树树树道道道道道道道道道道道道道树树树树树树树树树树树树树树树树树树树树树树树
石石石石石石石石石石石石石石石石石石石草草草草土土土土道道道道树树树树道道道道道道道道道道道道道树树树树树树树树树树树树树树树树树树树树树树树
石石石石石石石石石石石石石石石石石树树草草稂稂土土树树树树草草树树树树树花土花土道道道道道道道道树树树树树树树树树树树树树树树树树树树树树树树
石石石石石石石石石石石石石石石石石树树草草稂稂土土树树树树草草树树树树树土花土花道道道道飾飾飾飾树树树树树树树树树树树树树树树树树树树树树树树
石石石石石石石石石石石石石石石石石树树树树稂稂草草树树树树草草树树树树树飾飾飾飾道道道道飾飾飾飾树树树树树树树树树树树树树树树树树树树树树树树
石石石石石石石石石石石石石石石石石树树树树稂稂草草树树树树草草树树树树树無门無無道道道道無無無無树树树树树树树树树树树树树树树树树树树树树树树
石石石石石石石石石石石石石石石石石树树树树稂稂土土树树草草草草飾飾飾飾树道道道道道道道道無门無無树树树树树树树树树树树树树树树树树树树树树树树
石石石石石石石石石石石石石石石石石树树树树稂稂土土树树草草草草無门無無树道道道道道道道道道道树树树树树树飾飾飾飾树树树树树树树树树树树树树树树
石石石石石石石石石石石石石石石石石树树树树稂稂草草土土土土草草土土土树树土土土土土土道道道道树树水水树土無门無無树树树树树树树树树树树树树树树
石石石石石石石石石石石石石石石石石树树树树稂稂草草土土土土草草土花土树树土土土土土土道道树树树土水水土土土土土土树树树树树树树树树树树树树树树
石石石石石石石石石石石石石石石石石树树树树稂稂稂稂树树树树土土花土花树树树树树树树土道道树树树土水水土土土土土土树树树树树树树树树树树树树树树
石石石石石石石石石石石石石石石石石树树树树稂稂稂稂树树树树土土土花土树树树树树树树土道道树树土土水水土土树树树树树树树树树树树树树树树树树树树
石石石石石石石石石石石石石石石石石树树树树树树稂稂树树树树树树树树树树树树树树树树土道道树树土土土土土土树树树树树树树树树树树树树树树树树树树
石石石石石石石石石石石石石石石石石树树树树树树稂稂树树树树树树树树树树树道道道道道道道道树树树草草草草草草树树树树树树树树树树树树树树树树树树
石石石石石石石石石石石石石石石石石树树树树树树树树树树树树树树树树树树树道道道道道道道道树树树树稂稂稂草土树树树树树树树树树树树树树树树树树树
石石石石石石石石石石石石石石石石石树树树树树树树树树树树树树树树树树树树道道草草草草草树树树树稂稂稂稂草草树树树树树树树树树树树树树树树树树树
石石石石石石石石石石石石石石石石石石石石石石石石石石石石石石石石石石树树無無無無無草草树树树树稂稂稂稂稂树树树树树树树树树树树树树树树树树树树
石石石石石石石石石石石石石石石石石石石石石石石石石石石石石石石石石石树树道道草草草草草树树树树树稂稂稂稂树树树树树树树树树树树树树树树树树树树
石石石石石石石石石石石石石石石石石石石石石石石石石石石石石石石石石石石石道道草草草草草草树树树树树树草稂树树树树树树树树树树树树树树树树树树树
石石石石石石石石石石石石石石石石石石石石石石石石石石石石石石石石石石石石道道草草草草草土土树树树树树草草树树树树树树树树树树树树树树树树树树树
石石石石石石石石石石石石石石石石石石石石石石石石石石石石草草土土土土土土道道道道道道道土土树树树树树草草树树树树树树树树树树树树树树树树树树树
石石石石石石石石石石石石石石石石石石石石石石石石石石石石草草土土土土土土道道道道道道道土土树树树树树草草树树树树树树树树树树树树树树树树树树树
石石石石石石石石石石石石石石石石石石石石石石石石石石石石土土草草石石石石石石石石石道道土土树树树树树草稂树树树树树树树树树树树树树树树树树树树
石石石石石石石石石石石石石石石石石石石石石石石石石石石石土土草草石稂稂草草草草土土道道土土树树树树树稂稂稂树树树树树树树树树树树树树树树树树树
石石石石石石石石石石石石石石石石石石石石石石石石石石石石土土石石石稂稂草草草草土土道道土土树树树树稂稂稂稂树树树树树树树树树树树树树树树树树树
石石石石石石石石石石石石石石石石石石石石石石石石石石石石土土石石石稂草草草道道道道道道土树树树树树稂稂稂稂树树树树树树树树树树树树树树树树树树
石石石石石石石石石石石石石石石石石石石石石石石石石石石石草土石石石稂草草草道道道道道道树树树树树树稂稂稂稂树树树树树树树树树树树树树树树树树树
石石石石石石石石石石石石石石石石石石石石石石石石石石石草土草石石石石石草草道道無無無無树树树树树树树稂稂稂树树树树树树树树树树树树树树树树树树
石石石石石石石石石石石石石石石石石石石石石石石石石石草草草稂石石石石石草草道道無土土土树树树树树树树草稂树树树树树树树树树树树树树树树树树树树
石石石石石石石石石石石石石石石石石石石石石石石石石草稂稂稂稂石石石石石石石道道無土草草無土土树树树树草草树树树树树树树树树树树树树树树树树树树
石石石石石石石石石石石石石石石石石石石石石石石石石稂稂稂稂稂稂石石石石石石道道土土草草土土土土土土土土草树树树树树树树树树树树树树树树树树树树
石石石石石石石石石石石石石石石石石石石石石石石石石稂稂稂稂草稂草石石石石石土土無土草草無土土土土树树树树树树树树树树树树树树树树树树树树树树树
石石石石石石石石石石石石石石石石石石石石石石石石石稂草稂草草草草草石石石土土土無土草草無土土土土树树树树树树树树树树树树树树树树树树树树树树树
石石石石石石石石石石石石石石石石石石石石石石石石石石石石石石石草草土土無土土土树土草草無土土土树树树树树树树树树树树树树树树树树树树树树树树树
石石石石石石石石石石石石石石石石石石石石石石石石石石石石石石石草草土土無土土土树树草草無無無無树树树树树树树树树树树树树树树树树树树树树树树树
石石石石石石石石石石石石石石石石石石石石石石石石石石石石石石石石石土土無土土土树树草草草草土土树树树树树树树树树树树树树树树树树树树树树树树树
石石石石石石石石石石石石石石石石石石石石石石石石石石石石石飾飾飾飾土土無土树土树树草草草草土土树树树树树树树树树树树树树树树树树树树树树树树树
石石石石石石石石石石石石石石石石石石石石石石石石石石石石石無门無無土土树树树土树树树树草草土土树树树树树树树树树树树树树树树树树树树树树树树树
石石石石石石石石石石石石石石石石石石石石石石石石石石石石石土土土土土土树树树土树树树树草草土树树树树树树树树树树树树树树树树树树树树树树树树树
石石石石石石石石石石石石石石石石石石石石石石石石石石石石石土土土土土土树树土土树树树树树土土树树树树树树树树树树树树树树树树树树树树树树树树树
石石石石石石石石石石石石石石石石石石石石石石石石石石石石石石石石石土土树树無树树树树土土土土树树树树树树树树树树树树树树树树树树树树树树树树树
石石石石石石石石石石石石石石石石石石石石石石石石石石石石石石石石石土土土树土树树树树土土土树树树树树树树树飾飾飾飾树树树树树树树树树树树树树树
石石石石石石石石石石石石石石石石石石石石石石石石石石石石石石石石石土土土土土树树土土土土树树树树树树树树树飾飾飾飾树树树树树树树树树树树树树树
石石石石石石石石石石石石石石石石石石石石石石石石石石石石石石石石土土土土土土土無土土土土土土树树树树树土土無無無無草草草树树树树树树树树树树树
石石石石石石石石石石石石石石石石石石石石石石石石石石石石石石石石土土土土土土土無土土土土土土树树树树树土土無门無無草草草树树树树树树树树树树树
石石石石石石石石石石石石石石石石石石石石石石石石石石石石石石石土土土土土土土土無土土土土土土树树树树树道道道道道土土草草树树树树树树树树树树树
石石石石石石石石石石石石石石石石石石石石石石石石石石石石石石石土土土土土土土土無土土土土土土道道道道道道道道道道土飾草草树树树树树树树树树树树
石石石石石石石石石石石石石石石石石石石石石石石石石石石石石石石土土土土無無無無树土土土土土土道道道道道道道道道道土土草草树树树树树树树树树树树
石石石石石石石石石石石石石石石石石石石石石石石石石石石石石石石土土土土無土土土树树土土土土土树树树树树道道道道道土土草草树树树树树树树树树树树
石石石石石石石石石石石石石石石石石石石石石石石石石石石石石石石道道道道土土土土树土土土土树树树树树树树树土土土土草草草草树树树树树树树树树树树
石石石石石石石石石石石石石石石石石石石石石石石石石石石石石石石道道道道土土土土树土土土树树树树树树树树树土土土土草草草草树树树树树树树树树树树
石石石石石石石石石石石石石石石石石石石石石石石石石石石石石石石道道土土無土土土树树草草树树树树树树树树树树树草草草草草草树树树树树树树树树树树
石石石石石石石石石石石石石石石石石石石石石石石石石石石石石石石道道土土無土土土树树草草树树树树树树树树树树树草草草草草草树树树树树树树树树树树
石石石石石石石石石石石石石石石石石石石石石石石石石石石石石石石道道树树树土土土树树草草草草树树树树树树树树树树树树树树树树树树树树树树树树树树
石石石石石石石石石石石石石石石石石石石石石石石石石石石石石石石道道树树树树土土树树草草草草树树树树树树树树树树树树树树树树树树树树树树树树树树
石石石石石石石石石石石石石石石石石石石石石石石石石石石石石石石土土树树树树土土土土草草土土树树树树树树树树树树树树树树树树树树树树树树树树树树
石石石石石石石石石石石石石石石石石石石石石石石石石石石石石石石土土树树树树土土土土草草土土树树树树树树树树树树树树树树树树树树树树树树树树树树
石石石石石石石石石石石石石石石石石石石石石石石石石石石石石石石土土草草草草草草土土树树稂稂稂稂树树树树树树树树树树树树树树树树树树树树树树树树
石石石石石石石石石石石石石石石石石石石石石石石石石石石石石石石土土草草草草草草土土树树稂稂稂稂树树树树树树树树树树树树树树树树树树树树树树树树
石石石石石石石石石石石石石石石石石石石石石石石石石石石石石石石草草草草草草草草土土草草稂稂稂稂树树树树树树树树树树树树树树树树树树树树树树树树
石石石石石石石石石石石石石石石石石石石石石石石石石石石石石石石草草草草草草草草土土草草稂稂稂稂树树树树树树树树树树树树树树树树树树树树树树树树
石石石石石石石石石石石石石石石石石石石石石石石石石石石石石石石草草草草草草草草土土树树稂稂稂稂树树树树树树树树树树树树树树树树树树树树树树树树
石石石石石石石石石石石石石石石石石石石石石石石石石石石石石石石無無無無無無無無土土树树稂稂稂稂树树树树树树树树树树树树树树树树树树树树树树树树
石石石石石石石石石石石石石石石石石石石石石石石石石石石石石石石石石草草草草草草土土树树树树树树树树树树树树树树树树树树树树树树树树树树树树树树
石石石石石石石石石石石石石石石石石石石石石石石石石石石石石石石石石草草草草草草土土树树树树树树树树树树树树树树树树树树树树树树树树树树树树树树
石石石石石石石石石石石石石石石石石石石石石石石石石石石石石石石石石草草草草草草土土树树树树树树树树树树树树树树树树树树树树树树树树树树树树树树
石石石石石石石石石石石石石石石石石石石石石石石石石石石石石石石石石草草草草草草土土树树树树树树树树树树树树树树树树树树树树树树树树树树树树树树
石石石石石石石石石石石石石石石石石石石石石石石石石石石石石石石石石石石草草草草土土树树树树树树树树树树树树树树树树树树树树树树树树树树树树树树
石石石石石石石石石石石石石石石石石石石石石石石石石石石石石石石石石石石草草草草土土树树树树树树树树树树树树树树树树树树树树树树树树树树树树树树
石石石石石石石石石石石石石石石石石石石石石石石石石石石石石石石石石石石草草土土土土树树树树树树树树树树树树树树树树树树树树树树树树树树树树树树
石石石石石石石石石石石石石石石石石石石石石石石石石石石石石石石石石石石树树土土土土树树树树树树树树树树树树树树树树树树树树树树树树树树树树树树
石石石石石石石石石石石石石石石石石石石石石石石石石石石石石石石石石石石树树土土草草草草树树树树树树树树树树树树树树树树树树树树树树树树树树树树
石石石石石石石石石石石石石石石石石石石石石石石石石石石石石石石石石石石树树土土草草草草树树树树树树树树树树树树树树树树树树树树树树树树树树树树
石石石石石石石石石石石石石石石石石石石石石石石石石石石石石石石石石石石树树土土草草草草树树树树树树树树树树树树树树树树树树树树树树树树树树树树
石石石石石石石石石石石石石石石石石石石石石石石石石石石石石石石石石树树草草土土草草草草树树树树树树树树树树树树树树树树树树树树树树树树树树树树
石石石石石石石石石石石石石石石石石石石石石石石石石石石石石石石石石树树草草土土草草树树树树树树树树树树树树树树树树树树树树树树树树树树树树树树
石石石石石石石石石石石石石石石石石石石石树树树树树树树树树石石石石树树草草草草草草树树树树树树树树树树树树树树树树树树树树树树树树树树树树树树
石石石石石石石石石石石石石石石石石石树树树树树树树树树树树树树石石树树草草草草草草树树树树树树树树树树树树树树树树树树树树树树树树树树树树树树
石石石石石石石石石石石石石石石树树树树树树树土树树树树树树树树树树草草草草土土草草树树树树树树树树树树树树树树树树树树树树树树树树树树树树树树
石石石石石石石石石石石石石树树树树树树树树树土土树树树树树树树树树草草草草土土草草树树树树树树树树树树树树树树树树树树树树树树树树树树树树树树
石石石石石石石石石石石石石树树树树树土树树树土土树树树树树草草土土土草草土土土树树树树树树树树树树树树树树树树树树树树树树树树树树树树树树树树
石石石石石石石石石石石石石树树水水土土土土土土花树树树树树草草土土土草草土土土树树树树树树树树树树树树树树树树树树树树树树树树树树树树树树树树
石石石石石石石石石石石石石树树水水土土土土土花花树树树树树土土土土草草草草树树树树树树树树树树树树树树树树树树树树树树树树树树树树树树树树树树
石石石石石石石石石石石石石树树水水水土土土土树树树树树树树土土土土草草草草树树树树树树树树树树树树树树树树树树树树树树树树树树树树树树树树树树
石石石石石石石石石石石石石石石石水水水飾门飾飾树树树树树树树树道道树树树树树树树树树树树树树树树树树树树树树树树树树树树树树树树树树树树树树树
石石石石石石石石石石石石石石石石石水水飾飾飾飾树树树树树树树树道道树树树树树树树树树树树树树树树树树树树树树树树树树树树树树树树树树树树树树树
石石石石石石石石石石石石石石石石石水水無無無無树树花花飾飾飾飾道道树树树树树树树树树树树树树树树树树树树树树树树树树树树树树树树树树树树树树树
石石石石石石石石石石石石石石石石石水水無门無無树树土土飾飾飾飾道道树树树树树树树树树树树树树树树树树树树树树树树树树树树树树树树树树树树树树树
石石石石石石石石石树树树树树树石石水水道道道道道道土土無無無無道道树树树树树树树树树树树树树树树树树树树树树树树树树树树树树树树树树树树树树树
石石石石石石石石石树树树树树树石石水水道道道道道道土土無门無無道道树树树树树树树树树树树树树树树树树树树树树树树树树树树树树树树树树树树树树树
土土土土土土草草草树树土土道道道無道道道道道道道道道道道道道道道道树树树树树树树树树树树树树树树树树树树树树树树树树树树树树树树树树树树树树树
土土土土土土草草草树树土土道道道無道道道道道道道道道道道道道道道道树树树树树树树树树树树树树树树树树树树树树树树树树树树树树树树树树树树树树树
树树树树土土土土土土土土土石石石石石飾飾飾飾道道道道道道道道道道道道無道道道道道道道道道树树树树树树树树树树树树树树树树树树树树树树树树树树树
树树树树土土土土土土土土土石石石石石飾飾飾飾道道道道道道道道道道道道無道道道道道道道道道树树树树树树树树树树树树树树树树树树树树树树树树树树树
石石石石石石草草草草草草草石石石石石無無無無道道道飾飾飾飾飾飾土树树树树树树树树树树道道树树树树树树树树树树树树树树树树树树树树树树树树树树树
石石石石石石草草草草草草草石石石石石無门無無道道道飾飾飾飾飾飾土树树树树树树树树树树道道树树树树树树树树树树树树树树树树树树树树树树树树树树树
石石石石石石石石石石石石石石石石花土道道道道道道土無無無無無無土树树树树树树树树树树道道树树树树树树树树树树树树树树树树树树树树树树树树树树树
石石石石石石石石石石石石石石石石土花道道道道道道土無無门無無無土树树树树树树树树树树道道树树树树树树树树树树树树树树树树树树树树树树树树树树树
石石石石石石石石石石石石石石石石石石土土土土道道道道道道道道道土树树树树树树树树树树道道树树树树树树树树树树树树树树树树树树树树树树树树树树树
石石石石石石石石石石石石石石石石石石石石石石道道道道道道道道道树树树树树树树树树树树道道树树树树树树树树树树树树树树树树树树树树树树树树树树树
石石石石石石石石石石石石石石石石石石石石石石石石石树树树树树树树树树树树树树树树树树道道道道道道道道道道道道道道道道道道道道道道道道道道道道树
石石石石石石石石石石石石石石石石石石石石石石石石石树树树树树树树树树树树树树树树树树道道道道道道道道道道道道道道道道道道道道道道道道道道道道树
石石石石石石石石石石石石石石石石石石石石石石石石石树树树树树树树树树树树树树树树树树树树树树树树树树树树树树树树树树树树树树树树树树树树道道树
石石石石石石石石石石石石石石石石石石石石石石石石石树树树树树树树树树树树树树树树树树树树树树树树树树树树树树树树树树树树树树树树树树树树道道树
石石石石石石石石石石石石石石石石石石石石石石石石石树树树树树树树树树树树树树树树树树树树树树树树树树树树树树树树树树树树树树树树树树树树道道树
石石石石石石石石石石石石石石石石石石石石石石石石石石树树树树树树树树树树树树树树树树树树树树树树树树树树树树树树树树树树树树树树树树树树道道树
石石石石石石石石石石石石石石石石石石石石石石石石石石树树树树树树树树树树树树树树树树树树树树树树树树树树树树树树树树树树树树树树树树树树道道树
石石石石石石石石石石石石石石石石石石石石石石石石石石树树树树树树树树树树树树树树树树树树树树树树树树树树树树树树树树树树树树树树树树树树道道树
石石石石石石石石石石石石石石石石石石石石石石石石石石树树树树树树树树树树树树树树树树树树树树树树树树树树树树树树树树树树树树树树树树树树道道树
石石石石石石石石石石石石石石石石石石石石石石石石石石树树树树树树树树树树树树树树树树树树树树树树树树树树树树树树树树树树树树树树树树树树道道树
石石石石石石石石石石石石石石石石石石石石石石石石石石树树树树树树树树树树树树树树树树树树树树树树树树树树树树树树树树树树树树树树树树树树道道树
石石石石石石石石石石石石石石石石石石石石石石石石石石树树树树树树树树树树树树树树树树树树树树树树树树树树树树树树树树树树树树树树树树树树道道树
石石石石石石石石石石石石石石石石石石石石石石石石石石树树树树树树树树树树树树树树树树树树树树树树树树树树树树树树树树树树树树树树树树树树道道树
石石石石石石石石石石石石石石石石石石石石石石石石石石树树树树树树树树树树树树树树树树树树树树树树树树树树树树树树树树树树树树树树树树树树道道树
石石石石石石石石石石石石石石石石石石石石石石石石石石石树树树树树树树树树树树树树树树树树树树树树树树树树树树树树树树树树树树树树树树树树道道树
石石石石石石石石石石石石石石石石石石石石石石石石石石石树树树树树树树树树树树树树树树树树树树树树树树树树树树树树树树树树树树树树树树树树道道树
石石石石石石石石石石石石石石石石石石石石石石石石石石石树树树树树树树树树树树树树树树树树树树树树树树树树树树树树树树树树树树树树树树树树道道树