穴穴穴穴穴穴穴穴穴穴穴穴穴穴穴┌┻┻┻┛┫草草草草草草草草道道土土树土土土土树道道土水土水华水土道道道道道道道道道道道土土土土土土土土土草草草
穴穴穴穴穴穴穴穴穴穴穴穴穴穴穴┫┌┻┻┻┛草草草草草草草草道道土土树树土树土土土道土水土土水水土道道道道道道道道道道道土土土土土土土土土草草草
穴穴穴穴穴穴穴穴穴穴穴穴穴穴穴┫┫树树草草草草土土土土道道道道树树树树树花土花土道土水水水水水土道土土树树树树树树树树树树树树树树树树树土土树
穴穴穴穴穴穴穴穴穴穴穴穴穴穴穴┫┫树树草草草草土土土土道道道道树树树树土土花土花道土土土土土土土道土树树树树树树树树树树树树树树树树树树土土树
穴穴穴穴穴穴穴穴穴穴穴穴穴穴穴┳┳┱┓草草稂稂土土树树树树草草树树树树树飾飾飾飾道道道道道道道道道树树树树树树树树树树树树树树树树树树树草草草
穴穴穴穴穴穴穴穴穴穴穴穴穴穴穴穴穴┫┫草草稂稂土土树树树树草草树树树树树飾飾飾飾道道道道飾飾飾飾树树树树树树树树树树树树树树树树树树树树草草草
穴穴穴穴穴穴穴穴穴穴穴穴穴穴穴穴穴┫┫树树稂稂草草树树树树草草树树树树树無無無無道道道道飾飾飾飾树树树树树树树树树树树树树树树树树树树树树树土
穴穴穴穴穴穴穴穴穴穴穴穴穴穴穴穴穴┫┫树树稂稂草草树树树树草草树树树树树無门買無道道道道無無無無树树树树树树树树树树树树树树树树树树树树树树土
穴穴穴穴穴穴穴穴穴穴穴穴水水水水穴┫┫树树稂稂土土树树草草草草飾飾飾飾树土道道道道道道道無门館無┏┲┲┳┳┳┳┳┱┱┓树树树树树树树树树树树土
穴穴穴穴穴穴穴穴穴穴水水水穴穴穴穴┫┫树树稂稂土土树树草草草草無门無無树土土土道道道道道道道树┏┲┲┳土飾飾飾飾┫┫┫树树树树树树树树树树树土
穴穴穴穴穴穴穴穴水水水穴穴┌┻┻┻┛┫树树稂稂草草土土土土草草土土土树树树土土土土土道道道土树┣┣┣树土無门無無┫┫┫树树树树树树树树树树树树
穴穴穴穴穴穴穴水水穴穴穴穴┫┌┻入┻┛树树稂稂草草土土土土草草土花土土树树树花土土土道道土树树┣┣┣土土土土土土┫┫┫树树树树树树树树树树树树
┻┻┻┻┐穴水水穴穴穴穴穴┫┫稂稂稂稂树树稂稂稂稂树树树树土土花土花土树树树树树树土道道树树树┣┣┣土土土土土土┫┫┫树树树树树树树树树树树树
嶝嶝嶝嶝┣水水穴穴穴穴穴穴┫┫稂稂稂稂树树稂稂稂稂树树树树土土土花土树树树树树树树土道道树树树┣┣┣土土草草草草┫┫┫树树树树树树树树树树树树
嶝嶝嶝水水水穴穴穴穴穴穴穴┫┫树树稂稂树树树树稂稂树树树树树树树树树树树树树树树树土道道树树树┣┣┣土草草稂草草┫┫┫树树树树树树树树树树树树
嶝水水水┗┻┐穴穴穴穴穴穴┫┫树树稂稂树树树树稂稂树树树树树树树树树树树土土道道道道道道树树树┣┣┣草草草稂草树┫┫┫树树树树树树树树树树树树
水水嶝嶝嶝嶝┣穴穴穴穴穴穴┫┳┳┓稂稂稂稂稂稂稂稂树树树树树树树树树树树土土道道道道道道树树树┣┣┣稂草稂稂草树┫┫┫树树树树树树树树树树树树
嶝飾飾飾飾嶝┗┐穴穴穴穴穴┫穴穴┫稂稂稂稂稂稂稂稂树树树树树树树树树树树土土草草草草草树树树树┣┣┣稂稂稂草草树┫┫┫树树树树树树树树树树树树
嶝飾飾飾飾嶝嶝┗┻┐穴穴穴┳┳┳┳┳┳┳┳┳┳┳┳┳┳┳┳┳┳┳┱┳┳┳┳┳┳┳┓草草树树树树┣┣┣稂稂稂草草草┫┫┫树树树树树树树树树树树树
嶝無無無無嶝嶝嶝嶝┗┐穴穴穴穴穴穴穴穴穴穴穴穴穴穴穴穴穴穴穴穴穴┫树树树土土草草─草草树树树树┣┣┣稂┏┳┓草草┫┫┫树树树树树树树树树树树树
嶝無门買無嶝嶝嶝嶝嶝┗┻┻┐┌入┐穴穴穴穴穴穴穴穴穴┌┻┻┻┻┻┛树树树土土草草─草草草树树树┣┣┣┏┳水┫草树┫┫┫树树树树树树树树树树树树
道道道嶝嶝飾飾飾飾嶝嶝嶝嶝┗┛嶝┣穴穴穴穴穴穴穴穴穴┫┌┻┻┻┻┐树树土土土草草┳┳┳┳┳┳┳┳┣┣┣水水┫草树┫┫┫树树树树树树树树树树树树
飾嶝道嶝嶝無门無無道道嶝嶝嶝嶝嶝┣穴穴穴穴穴穴穴穴穴┫┫草草土土═土土土土土土土土土土草草树树树┣┣┗┻滝┛草树┫┫┫树树树树树树树树树树树树
飾嶝道嶝嶝嶝道道道道嶝嶝嶝嶝┏┳┳穴穴穴穴穴穴穴穴穴┫┫草草土土═土土土土土土土土土土草草树树树┣┣草草水稂稂树┫┫┫树树树树树树树树树树树树
無道道道道道道嶝嶝嶝嶝┏┳┳┳穴穴穴穴穴穴穴穴穴穴穴┫┫土土草草┣稂稂草草草草草草土土草草树树树┣┣树稂水稂稂树┫┫┫树树树树树树树树树树树树
無道飾飾飾飾嶝嶝┏┳┳┳穴穴穴穴穴穴穴穴穴穴穴穴穴穴┫┫土土草草┣稂稂草草草草草草土土草草树树树┣┣树稂水圯水树┫┫┫树树树树树树树树树树树树
道道無门無無┏┳┳穴穴穴穴穴穴穴穴穴穴穴穴穴穴穴穴穴┫┫土土┏┳┳稂稂草草草草草草土土草草树树树┣┣树稂稂稂水水┫┫┫树树树树树树树树树树树树
嶝道道道嶝┏┳穴穴穴穴穴穴穴穴穴穴穴穴穴穴穴穴穴穴┌┛┫土土┣┏┓稂草草草土土土土土土草树树树树┣┣树树稂稂稂水┫┫┫树树树树树树树树树树树树
┏┳┳┳┳┳穴穴穴穴穴穴穴穴穴穴穴穴穴穴穴穴穴穴┌┛┌┛草土┣┣┫稂草草草土土土土土土树树树树树┣┣树稂稂稂稂水┫┫┫树树树树树树树树树树树树
┳穴穴穴穴穴穴穴穴穴穴穴穴穴穴穴穴穴穴穴穴穴穴┌┛┌┛草土草┣┣┳┳┓草草土土┏┳┳┳┳┳┳┳┳┳┣稂稂稂稂稂水┫┫┫树树树树树树树树树树树树
穴穴穴穴穴穴穴穴穴穴穴穴穴穴穴穴穴穴穴穴穴穴穴┫┌┛草草草稂┣┗┐穴┫草草土土┣穴穴穴穴穴穴穴穴穴┣草稂稂稂水水┫┫┫树树树树树树树树树树树树
穴穴穴穴穴穴穴穴穴穴穴穴穴穴穴穴穴穴穴穴穴穴穴┫┫草稂稂稂稂┗┐┗┐┳┳┓土土┣穴穴穴┏┳┳┳┳┳┳草草草树水树┫┫┫树树树树树树树树树树树树
穴穴穴穴穴穴穴穴穴穴穴穴穴穴穴穴穴穴穴穴穴穴穴┫┫稂稂稂稂稂稂┗┐┗┐穴┫土土═穴穴穴═土土土土土土土草树树水树┫┫┫树树树树树树树树树树树树
穴穴穴穴穴穴穴穴穴穴穴穴穴穴穴穴穴穴穴穴穴穴穴┫┫稂稂稂稂草稂草┗┐┗┻┛土土┣穴穴穴┣土土土土树树树树树树水树┫┫┫树树树树树树树树树树树树
穴穴穴穴穴穴穴穴穴穴穴穴穴穴穴穴穴穴穴穴穴穴穴┫┫稂草稂草草草草草┗┻┐土土土┣穴穴穴┣土土土土树树水水水水水树┫┫┫树树树树树树树树树树树树
穴穴穴穴穴穴穴穴穴穴穴穴穴穴穴穴穴穴穴穴穴穴穴┫┳┳┳┳┳┳┓草草土土┣土土土┣穴穴穴┣土土土树水水水树树树树树┫┫┫树树树树树树树树树树树树
穴穴穴穴穴穴穴穴穴穴穴穴穴穴穴穴穴穴穴穴穴穴穴┳┳┳┳┓穴穴┳┳┓土土┣土土土┣穴穴穴┗┻┻┻┻滝┻┻┻┻┻┻┻┛┫┫树树树树树树树树树树树树
穴穴穴穴穴穴穴穴穴穴穴穴穴穴穴穴穴穴穴穴穴穴穴穴穴穴穴┫┌┻┻┻┛土土┣土土土┣穴穴穴穴穴穴穴穴水穴穴穴穴穴穴穴穴┫┫树树树树树树树树树树树树
穴穴穴穴穴穴穴穴穴穴穴穴穴穴穴穴穴穴穴穴穴穴穴穴穴穴穴┫┫飾飾飾飾土土┣土树土┣穴穴穴穴穴穴穴穴水穴穴穴穴穴穴穴穴┫┫树树树树树树树树树树树树
穴穴穴穴穴穴穴穴穴穴穴穴穴穴穴穴穴穴穴穴穴穴穴穴穴穴穴┫┫無门無無土土┣树树土┣穴穴穴穴穴穴穴水水穴穴穴穴穴穴穴穴┫┫树树树树树树树树树树树树
穴穴穴穴穴穴穴穴穴穴穴穴穴穴穴穴穴穴穴穴穴穴穴穴穴穴穴┫┫花土花花土土┣树树土┗┻┻┻┻┻║┻滝┻┻┻┻┻┻┻┻┻┛┫树树树树树树树树树树树树
穴穴穴穴穴穴穴穴穴穴穴穴穴穴穴穴穴穴穴穴穴穴穴穴穴穴穴┫┫土土土土土土┣树土土树树树树树土土树水树树树树树树树树树树┫树树树树树树树树树树树树
穴穴穴穴穴穴穴穴穴穴穴穴穴穴穴穴穴穴穴穴穴穴穴穴穴穴穴┫┳┳┳┳┓土土┗┻║┻┻┻┻┻┻║┻┻滝┻┻┻┻┻┻┻┻┻┻┛树树树树树树树树树树树树
穴穴穴穴穴穴穴穴穴穴穴穴穴穴穴穴穴穴穴穴穴穴穴穴穴穴穴┳┳┳┓穴┫土土土树土树树树树土土土树水水树树树树树飾飾飾飾树树树树树树树树树树树树树树
穴穴穴穴穴穴穴穴穴穴穴穴穴穴穴穴穴穴穴穴穴穴穴穴穴穴穴穴穴穴┫┌┛土土土土土树树土土土土树树水水水水水树树飾飾飾飾树树树树树树树树树树树树树树
穴穴穴穴穴穴穴穴穴穴穴穴穴穴穴穴穴穴穴穴穴穴穴穴穴穴穴穴穴┌┛┫土土土土土土土┏┓土土土土土水水水水水土土無無無無草草草树树树树树树树树树树树
穴穴穴穴穴穴穴穴穴穴穴穴穴穴穴穴穴穴穴穴穴穴穴穴穴穴穴穴穴┫┌┛土土土土土土土┣┫土土土土土水水水水水水土無门無無草草草树树树树树树树树树树树
穴穴穴穴穴穴穴穴穴穴穴穴穴穴穴穴穴穴穴穴穴穴穴穴穴穴穴穴穴┫┫土土土土土土土土┣┫土土土土土土水土土水水土土土土土土草草树树树树树树树树树树树
穴穴穴穴穴穴穴穴穴穴穴穴穴穴穴穴穴穴穴穴穴穴穴穴穴穴穴穴穴┫┫土土土土土土土土┣┫土土土土土土橋土土土土土土土土土土草草树树树树树树树树树树树
穴穴穴穴穴穴穴穴穴穴穴穴穴穴穴穴穴穴穴穴穴穴穴穴穴穴穴穴穴┫┫土土土土┏┳┳┳┳┫土土土土土土水树树土土土土土土土土草草树树树树树树树树树树树
穴穴穴穴穴穴穴穴穴穴穴穴穴穴穴穴穴穴穴穴穴穴穴穴穴穴穴穴穴┫┫土土土土┣穴穴穴穴┫土土土土土树水树树树土土土土土土土草草树树树树树树树树树树树
穴穴穴穴穴穴穴穴穴穴穴穴穴穴穴穴穴穴穴穴穴穴穴穴穴穴穴穴穴┫┫道道道道═穴穴穴穴┫土土土树树树水树树树树土土土土草草草草树树树树树树树树树树树
穴穴穴穴穴穴穴穴穴穴穴穴穴穴穴穴穴穴穴穴穴穴穴穴穴穴穴穴穴┫┫道道道道═穴穴穴穴┫土土树树树树水树树树树土土土土草草草草树树树树树树树树树树树
穴穴穴穴穴穴穴穴穴穴穴穴穴穴穴穴穴穴穴穴穴穴穴穴穴穴穴穴穴┫┫道道土土┣穴穴穴穴┫草草树树树树水树树树树树树草草草草草草树树树树树树树树树树树
穴穴穴穴穴穴穴穴穴穴穴穴穴穴穴穴穴穴穴穴穴穴穴穴穴穴穴穴穴┫┫道道土土┣穴穴穴穴┫草草树树树树水树树树树树树草草草草草草树树树树树树树树树树树
穴穴穴穴穴穴穴穴穴穴穴穴穴穴穴穴穴穴穴穴穴穴穴穴穴穴穴穴穴┫┫道道树树┣穴穴穴穴┫草草草草树树水水树树树树树树树树树树树树树树树树树树树树树树
穴穴穴穴穴穴穴穴穴穴穴穴穴穴穴穴穴穴穴穴穴穴穴穴穴穴穴穴穴┫┫道道树树┗┻║║┻┛草草草草树树树水水树树树树树树树树树树树树树树树树树树树树树
穴穴穴穴穴穴穴穴穴穴穴穴穴穴穴穴穴穴穴穴穴穴穴穴穴穴穴穴┌┛┫土土树树树树土土土土草草土土树树树树水树树树树树树树树树树树树树树树树树树树树树
穴穴穴穴穴穴穴穴穴穴穴穴穴穴穴穴穴穴穴穴穴穴穴穴穴穴穴┌┛┌┛土土树树树树土土土土草草土土树树树树水树树树树树树树树树树树树树树树树树树树树树
穴穴穴穴穴穴穴穴穴穴穴穴穴穴穴穴穴穴穴穴穴穴穴穴穴穴穴┫┌┛穴土土草草草草草草土土树树稂稂稂稂树树水树树树树树树树树树树树树树树树树树树树树树
穴穴穴穴穴穴穴穴穴穴穴穴穴穴穴穴穴穴穴穴穴穴穴穴穴穴穴┫┫穴穴土土草草草草草草土土树树稂稂稂稂树树水树树树树树树树树树树树树树树树树树树树树树
穴穴穴穴穴穴穴穴穴穴穴穴穴穴穴穴穴穴穴穴穴穴穴穴穴穴穴┫┫穴┏┓草草草草草草草土土草草稂稂稂稂树树水树树树树树树树树树树树树树树树树树树树树树
穴穴穴穴穴穴穴穴穴穴穴穴穴穴穴穴穴穴穴穴穴穴穴穴穴穴┌┛┫穴┣┫草草草草草草草土土草草稂稂稂稂树树水树树树树树树树树树树树树树树树树树树树树树
穴穴穴穴穴穴穴穴穴穴穴穴穴穴穴穴穴穴穴穴穴穴穴穴穴穴┫穴─穴┗┛草草草草草草草土土树树稂稂稂稂树树水树树树树树树树树树树树树树树树树树树树树树
穴穴穴穴穴穴穴穴穴穴穴穴穴穴穴穴穴穴穴穴穴穴穴穴穴穴┫穴┳┳┲┳┳┳┳┳┱┓草土土树树稂稂稂稂树树水树树树树树树树树树树树树树树树树树树树树树
穴穴穴穴穴穴穴穴穴穴穴穴穴穴穴穴穴穴穴穴穴穴穴穴穴穴┫穴穴穴┣穴┌┻┻┻┛┫草土土树树树树树树树树水树树树树树树树树树树树树树树树树树树树树树
穴穴穴穴穴┏┲┳┲┳┳┳┳┳┳┳┳┳┳┳┳┳┳┱┱┳┱┳┓穴┣穴┫┌┻┻┻┛草土土树树树树树树树树水水树树树树树树树树树树树树树树树树树树树树
穴穴穴穴穴┣┣穴┣穴穴水水水水穴穴穴穴穴穴穴穴┫┫穴┫穴─穴┗┻┛┫草草草草草土土树树树树树树树树树水树树树树树树树树树树树树树树树树树树树树
穴穴穴穴穴┣┣穴┣穴穴水水水水穴穴穴穴穴穴穴穴┫┫穴┫穴┳┳┳┳┓┳┓草草草草土土树树树树树树树树树水水水水水水水水水水水水水水水水水水水水水
穴穴穴穴穴┣┣穴┣┌┻┻┻滝滝┻┻┻┐穴穴穴穴┫┳┓┫穴穴穴穴穴┳┓┫草草草草土土树树树树树树树树树树树树树树树树树树树树树树树树树树树树树树
穴穴穴穴穴┣┣穴┣┫┌┻┻滝滝┻┻┐┣穴穴穴穴┫穴┫┫穴穴岩穴穴穴┫┫草草草草土土树树树树树树树树树树树树树树树树树树树树树树树树树树树树树树
穴穴穴穴穴┣┣穴┣┫┫┌┻滝滝┻┐┣┣穴穴穴穴┫穴──穴穴穴穴岩穴┫┫草草土土土土树树树树树树树树树树树树树树树树树树树树树树树树树树树树树树
穴穴穴穴穴┣┣穴┣┫┫┫┌滝滝┐┣┣┣穴穴穴穴┫穴┫┫穴岩穴穴穴穴┫┫树树土土土土树树树树树树树树树树树树树树树树树树树树树树树树树树树树树树
穴穴穴穴穴┣┣穴┣┫┫┫┫水水┣┣┣┗┻┻┻┻┛穴┫┫穴穴穴穴岩穴┫┫树树土土草草草草树树树树树树树树树树树树树树树树树树树树树树树树树树树树
穴穴穴穴穴┣┣穴┣┫┫┫┫水水┣┣┗┻┻┻┻┻┻┻┛┫穴穴岩穴穴穴┫┫树树土土草草草草树树树树树树树树树树树树树树树树树树树树树树树树树树树树
穴穴穴穴穴┣┣穴┣┫┫┫┫水水┣┣┌┻┻┻┻┻┻┻┻┛穴穴穴穴穴┌┛┫树树土土草草草草树树树树树树树树树树树树树树树树树树树树树树树树树树树树
穴穴穴穴穴┣┣穴┗┛┫┫┫水水┣┗┛┌┻┻┻┻┻┻┻┻┻┻┻┐穴┫┌┛草草土土草草草草树树树树树树树树树树树树树树树树树树树树树树树树树树树树
穴穴穴穴穴┣┗┻┻┻┛┫┫水水┣┌┻┛┌┻┻┻┻┻┻┻┻┻┐┗┻┛┫树草草土土草草树树树树树树树树树树树树树树树树树树树树树树树树树树树树树树
穴穴穴穴穴┗┻┻┻┻┻┛┫水水┗┛┌┻┛树树树树树树树树树┗┻┐┌┛树草草草草草草树树树树树树树树树树树树树树树树树树树树树树树树树树树树树树
穴穴穴穴穴穴穴穴穴穴穴┌┛水水水穴┫树树树树树树树树树树树树树┗┛树树草草草草草草树树树树树树树树树树树树树树树树树树树树树树树树树树树树树树
穴穴穴穴穴穴穴穴穴穴穴┫┌┻滝滝┻┛树树树树土树树树树树树树树树树草草草草土土草草树树树树树树稂稂稂稂稂稂稂稂树树树树树树树树树树树树树树畑畑
┳┳┳┳┳┳┳┳┳┳┫┫┫树水水树树树树树树土土树树树树树树树树树草草草草土土草草树树树树树树稂稂稂稂稂稂稂草草草树树树树树树树树树树树树畑畑
穴穴穴穴穴穴穴穴穴穴┫┫┫树水水树树土树树树土土树树树树树草草土土土草草土土土树树树树树树树树稂稂稂稂稂稂稂草仏草稂稂稂稂稂树树树树树树树畑畑
┳┳┳┳┳┓穴穴穴穴┫┫┫树水水水土土土土土土花树树树树树草草土土土草草土土土树树树树树树树树稂稂稂無稂稂稂草草草稂稂稂稂稂稂树树树树树树畑畑
穴穴穴穴穴┫穴穴穴穴┫┫┫树水水水土土土土土花花树树树树树土土土土草草草草树树树树树树树树树树稂稂無無無稂稂稂稂稂稂稂稂稂稂稂稂树树树树树畑畑
┳┳┳┓穴┫穴穴穴穴┫┫┫树树水水水土土土土树树树树树树树土土土土草草草草树树树树树树树树树树稂無無门無無稂稂稂稂稂稂稂稂稂稂稂树树树树树畑畑
穴穴穴┫穴┫穴穴穴穴┫┫┳┳┳┓水水水飾门飾飾树树飾飾飾飾道道树树树树树树树树树树树树树树树树稂稂稂稂稂稂稂稂稂稂稂稂稂無稂稂稂树树树树树畑畑
┻┻┻┛穴┫穴穴穴穴┫┳┓树树┳┓水水飾飾飾飾树树無门無無道道树树树树树树树树树树树树树树树树稂稂稂稂稂稂稂稂稂稂稂稂無無無稂稂树树树树树畑畑
穴穴穴穴穴┫树树树树┳┓┫树树┌┛水水無無無無道道道道道道道道飾飾飾飾树树树树树树树树树树树树稂稂稂稂稂稂稂稂稂稂稂無無门無無稂树树树树树畑畑
┻┻┻┻┻┛树树树树树┫┫树树┫水水水無门無無道道道道道道道道飾飾飾飾树树树树树树树树树树树树稂稂稂稂稂稂稂稂稂稂稂稂稂稂稂稂稂树树树树树树树
树树树树树树树树树树树┫┫树树┫水水水道道道道道道土土土土道道無無無無树树树树树树树树树树树树稂稂稂稂稂稂稂稂稂稂稂稂稂稂稂稂树树树树树树树树
树树树树树树树树树树树┫┫树树┫水水土道道道道道道土土土土道道無门無無树树树树树树树树树树树树树树树树稂稂稂無稂稂稂树树树树树树草草草草草草草
草草草草草草稂稂树土土┫┫土土─橋橋道道道土土道道道道道道道道道道道道树树树树树树树树树树树树树树树树稂稂無無無稂稂树树树树树树草草草草草草草
草草草草草草稂稂树土土──土土┫水水土土土土土道道道道道道道道道道道道树树树树树树树树树树树树树树树树稂無無门無無稂树树树树树树草草树树树草草
稂稂稂稂草草草草土土土┫┫穴穴┫水水树树树土土土土土土树树土土道道飾飾飾飾飾飾树树树树树树树树树树树树稂稂稂稂稂稂稂树树树树树树草草树树树草草
稂稂稂稂草草草草土土土┫┫┌┻┛水水树树树土土土土土土树树土土道道飾飾飾飾飾飾树树树树树树树树树树树树树稂稂稂稂稂稂树树树树树树草草树树树草草
┳┳┳┳┳┓草草草草草┫┫┫水水水水土土土土土树树树树树树树树道道無無無無無無土土土土土土土草草树树树树稂稂稂稂稂稂树树树树草草草草草草草草草
草草草草草─草草草草草┫┫┫水水水水土土土土土树树树树树树树树道道無门無無门無土土土土土土土草草树树树树树树树稂稂树树树树树草草草草草草草草草
草草草草草┳┳┳┳┳┓┫┫┫水水花土土土树树树树树树树飾飾飾飾道道道道树树道道道道道道道土土草草树树树树树树树稂稂树树树树树草草水水水水水水水
┳┳┓草草草┏┳┳┓┫┫┫┫水水土花土土树树树树树树树飾飾飾飾道道道道树树道道道道道道道土土草草树树树树树树树稂稂树树树树树草草水水水水水水水
草草─草草草┣稂稂┫┫┫┫┫水水水水土土土土土土土土土無無無無树树树树树树树树树树树道道土土土土土土土树树草草草草草草草树树草草水水飾飾飾飾畑
草草┳┳┳┳┳稂稂┫┫┫┫┫水水水水土土土土土土土土土無门無無树树树树树树树树树树树道道土土土土土土土树树草草草草草草草树树草草水水無门無無畑
草草稂稂稂稂稂稂稂┫┫┫┫┳┳┓水水┏┳┳┳┳┳┓土土土土土花树树树树树树树树树土土道道道道道道道土土树树道道道道道道道树树道道橋橋道道道道畑
草草稂稂稂稂稂稂稂┫┫┫┳┳┓┫水水┣┏┳┳┳┓┫土土土土花土树树树树树树树树树土土道道道道道道道土土树树道道道道道道道树树道道橋橋道道道道畑
草草稂稂稂稂稂稂稂┳┳┳┱┓┫┫水水┣┣┏┳┓┫┫树树树树树树树树树树树树树草草土土草草草草草道道土土树树道道树树树道道树树道道水水树树道道树
畑畑畑畑稂稂稂稂稂稂稂稂┫┫┫┫水水┣┣┣穴┫┫┫树树树树树树树树树树树树树草草土土草草草草草道道土土树树道道稂稂稂道道树树道道水水树树道道树
畑畑畑畑稂稂稂稂稂稂稂稂┫┫┫┫水水┣┣┣穴┫┫┳┓树树树树树树树树树树树树草草土土树水水水水圯圯水水水水圯圯水水水圯圯水水圯圯水水树树道道树
畑畑畑畑稂稂稂稂稂稂稂稂┫┫┫┫水水┣┣┣穴┫┳┓┫树树树树树树树树树树树树草草土土树水水水水圯圯水水水水圯圯水水水圯圯水水圯圯水水树树道道树
畑畑畑畑稂稂稂┌┻┻┻┻┛┫┫┫水水┣┣┣穴┫穴┫┫树树树石石石石稂稂草草草草草土土树水水树树道道稂稂稂稂道道树树树道道道道道道树树树树土土土
畑畑畑畑稂稂稂┫┌┻┻┻┻┛┫┫水水┣┣┣穴┫穴┫┫树树树石石石石稂稂草草草草草土土树水水树树道道树树树树道道树树树道道道道道道树树树树土土土
畑畑畑畑稂道道┫┫穴穴穴穴穴──橋橋═══穴─穴┫┫土土土土土土土稂稂稂稂稂土土土土树水水树树道道道道道道道道树树树树树树树树树树树树树草草土
稂稂稂稂稂道道──穴穴穴穴穴┫┫水水┣┣┣穴┫穴──土土土土土土土稂稂稂稂稂土土土土树水水树树道道道道道道道道树树树树树树树树树树树树树草草土
道道道道道道道┫┫┌┻┻┻┻┛┫水水┣┣┣穴┫穴┫┫树石石草草土土稂稂土土土土土水水水水水树树树树树树树树树树树树树树树树树树树树树树树草草土
道道道道道道道┫┫┫┌┻┻┻┻┛水水┣┣┣穴┫┌┛┫树石石草草土土稂稂土土土土土水水水水水树树树树树树树树树树树树树树树树树树树树树树树草草土
稂稂稂稂稂稂稂┫┫┫┫水水水水水水水┣┣┣穴┫┫穴┫树树树树树土土土土土土水水水水水树树树树树树树树树树树树树树树树树树树树树树树树树树草草土
┌┻┻┻┻┻┻┛┫┫┫水水水水水水水┣┣┣穴┫┫穴┫树树树树树土土土土土土水水水水水树树树树树树树树树树树树树树树树树树树树树树树树树树土土土
┫┌┻┻┻┻┻┻┛┫┫水水┏┳┳┳┳┳┣┣穴┫┫穴┫土土树树树树树树水水水水水树树树树树树树树树树树树树树树树树树树树树树树树树树树树树土土土
┫┫┌┻┻┻┻┻┻┛┫水水┣穴穴穴穴┏┳┣穴┫┫穴┫土土树树树树树树水水水水水树树树树树树树树树树树树树树树树树树树树树树树树树树树树树土土树
┫┫┫┌┻┻┻┻┻┻┛水水┗┻┻┻┐┣穴┣穴┫┫穴─土土土土水水水水水水树树树树树树树树树树树树树树树树树树树树树树树树树树树树树树树树土土树