石石石石石石石石石石石石石石石石石石石石石石石石石石石石石石石石石石石石石石石石石石石石石石石石石石石石石石石石石石石石石石┫┫┳┳┳┓水水水水水圯水水水水水┣树树树树树树道┏┳┳┳┳┳┳┳┳
石石石石石石石石石石石石石石石石石石石石石石石石石石石石石石石石石石石石石石石石石石石石石石石石石石石石石石石石石石石石石石┫┫穴穴穴┫水水水水水圯水水水水水┣树树树树树树道┣树树树树树树树树
石石石石石石石石石石石石石石石石石石石石石石石石石石石石石石石石石石石石石石石石石石石石石石石石石石石石石石石石石石石石石石┫┫穴穴穴┳┳┳┳┳┳圯┳┳┓水水┣畑畑畑畑畑畑道┣树树树树树树树树
石石石石石石石石石石石石石石石石石石石石石石石石石石石石石石石石石石石石石石石石石石石石石┌┻┻┻┻┻┻┻┻┻┻┻┻┻┻┻┻┛┫穴穴穴穴穴穴穴穴穴穴穴穴┫水水┣畑畑畑畑畑畑道┣树树树树树树树树
石石石石石石石石石石石石石石石石石石石石石石石石石石石石石石石石石石石石石石石石石石石石石┫┌┻┻┻┻┻┻┻┻┻┻┻┻┻┻┻┻┛穴穴穴穴穴穴穴穴穴穴穴穴┫水水┣畑畑畑畑畑畑道┣树树树树树树树树
石石石石石石石石石石石石石石石石石石石石石石石石石石石石石石石石石石石石石石石石石石石石石┫┫穴穴穴┌┻┻┻┻┻┻┻┻┻┻┻┻┻┻┻┻┻┻┻┻┻┻┻圯┻┛水水┣畑畑畑畑畑畑道┣树树树树树树树树
石石石石石石石石石石石石石石石石石石石石石石石石石石石石石石石石石石石石石石石石石石石石石┫┫穴穴穴┫树花土土李树飾飾飾飾飾飾水水水水水水水水水水水圯水水水水┣畑畑畑畑畑畑道┣树树树树树树树树
石石石石石石石石石石石石石石石石石石石石石石石石石石石石石石石石石石石石石石石石石石石石石┫┫穴穴穴┫花土李树土土無门飾飾飾飾水水水水水水水水水水水圯水水水水┣畑畑畑畑畑畑道┣树树树树树树树树
石石石石石石石石石石石石石石石石石石石石石石石石石石石石石石石石石石石石石石石石石石石┌┻┛┫穴穴穴┫树树土李土土土土無無無無水水土土土土土┏┳┳┳圯┳┳┳┳┳土土飾飾飾飾道┣树树树树树树树树
石石石石石石石石石石石石石石石石石石石石石石石石石石石石石石石石石石石石石石石石石石石┫穴穴┫穴穴穴┫树树树树土土树树無门学無水水土土土土土┣土土土道土土土土土土土無门無無道┣树树树树树树树树
石石石石石石石石石┌┻┻┻┻┻┻┻┻┻┻┻┻┻┻┻┻┐石石石石石石石石石石石石石穴穴穴┫穴穴┫穴穴穴─土树树树树树土道道道土土水水土土土土土┣土道道道道道道道道道道道道道道道┗┐石石石石石石石
石石石石石石石石石┫┌┻┻┻┻┻┻┻┻┻┻┻┻┻┻┐┣石石石石石石石石石石石穴穴穴穴穴┫穴穴─穴穴穴┫土土土土土土土道飾飾飾飾水水飾飾飾飾土┣土道土土土土土土土土土土土土土土土┣石石石石石石石
石石石石石石石石石┫┫道道道道道道道道道道道道道道┣┗┻┻┻┻┻┻┻┻┻┻┻┻┻┻┻┻┛穴穴┫穴穴穴┫土土土土土土土道飾飾飾飾水水飾飾飾飾土┣土道土┏┳┳┳┳┓土树土树土土树土┣石石石石石石石
石石石石石石石石石┫┫道道道道道道道道道道道道道道┗┻┻┻┻┻┻┻┻┻┐穴穴穴穴穴穴穴穴穴穴┫穴穴穴┳┳┳┳┳┳┳┓道無無無無水水無無無無土┣土道土┣石石石石┫树树土土土树土土┣石石石石石石石
石石石┌┻┻┻┻┻┛┫道道┏┳┳┳┳┳┳┳┳┓道道道道道道道道道道道道═穴穴穴穴穴穴穴穴穴穴┫┏┳┓穴飾飾飾飾飾飾┫道無门買無水水無门館無土┣土道土┣石石石石┳┳┳┓土土土土树┣石石石石石石石
石石石┫┌┻┻┻┻┻┛道道┣穴穴穴穴穴穴穴穴┫道道道道道道道道道道道道┣穴穴穴穴穴穴穴穴穴穴┫┫┏┱┓飾飾飾飾飾飾┫道道道道道橋橋道道道道道═道道土┣石石石石石石石┳┳┳┳┳┳┳石石石石石石石
石石石┫┫道道道道道道道道┣穴穴穴穴穴穴穴穴┫穴穴┏┲┲┲┳┳┱┳┳┳┳┱┳┓穴穴穴穴穴穴┌┛┫┗┛┫無無無無無無┫飾飾飾飾道水水土土土土道┣土土土┣石石石石石石石石石石石石石石石石石石石石石
石石石┫┫道道道道道道道道┣穴穴穴穴穴穴穴穴┫穴穴┣┣┣┣穴穴┫穴穴穴穴┫穴┫穴穴穴穴穴穴┫穴┗┻┻┛無無门競無無┫無门無無道水水飾飾飾飾道┣┏┳┳┳石石石石石石石石石石石石石石石石石石石石石
石石石┫┫道道┌┻┻┻┻┐┣穴穴穴穴穴穴穴穴┫穴穴┣┣┣┣穴穴┳┳┓穴穴┫穴─穴穴穴穴穴穴┫┌┻┻┻┻┻┻║┻┻┻┛土道道道道水水無门無無道┣┣穴穴穴石石石石石石石石石石石石石石石石石石石石石
石石石┫┫道道┫┌┻┻┐┣┣穴穴穴水水穴穴穴┫穴穴┣┣┣┣穴穴穴穴─穴穴┫穴┫穴穴穴穴穴穴┫┫水水水水水水圯水水水水水水水水圯水水土道道道道┣┣穴穴穴石石石石石石石石石石石石石石石石石石石石石
石石石┫┫道道┫┫穴穴┣┣┣穴穴穴水水穴穴穴┫穴穴┣┣┣┗┻┻┻┻┛穴穴─穴┫┌┻┻┻┻┻┛┫水水水水水水圯水水水水水水水水圯水水土┏┳┳┳┳┣穴穴穴穴穴穴穴穴穴穴穴穴穴穴穴树树树树树树树树树
石石石┫┫道道┫┫穴穴┣┣┗┻║┻滝滝┻┻┻┛穴穴┣┣┗┻┻┻┻┻┻┻┻┛穴┫┫┌┻┻┻┻┻┛水水土土土土土土土土土土土土土土土土土┣┏┳┳┳┳穴穴穴穴穴穴穴穴穴穴穴穴穴穴穴树树树树树树树树树
石石石┫┫道道┫┫穴┏┳┣穴穴穴穴水水穴穴穴穴穴穴┣┗┻┻┻┻┻┻┻┻┻┻┻┛┫┫水水水水水水水水土土土土土土土土土土土土土土土土土══土土土穴穴穴穴穴穴穴穴穴穴穴穴穴穴穴穴树树树树树树树树树
石石石┫┫道道┫┫穴═穴┣穴穴水水水水穴穴穴穴穴穴┗┻┻┻┻┻┻┻┻┻┻┻┻┻┛┫水水水水水水水水土土┏┳┳┳┳┳┳┳┳┳┳┳┳┳┳┳┣土土土穴穴穴穴穴穴穴穴穴穴穴穴穴穴穴穴树树树树树树树树树
石石石石石道道┫┫穴┣穴═穴穴水水水水穴穴穴┌┻┻┻┻┻┻┻┻┻┻┻┻┻┻┻┻┻┛水水土土土土土土土土┣┳┳┳┳┳┳┳┳┳┳┳┳┳┳┳┳穴土土穴穴穴穴穴穴穴穴穴穴穴穴穴穴穴穴树树树树树树树树树
石石石石石道道┫┫┏┳穴┣穴穴水水穴穴穴穴穴┫土土土土土土土土土水水水水水水水水水水水土土土土土土土土┣穴穴穴穴穴穴穴穴穴穴穴穴穴穴穴穴穴土土穴穴穴穴穴穴穴穴穴穴穴穴穴穴穴穴树树树树树树树树树
道道道道道道道┫┫┣┏┳┳穴穴水水┌┻┻┻┻┛土土土土土土土土土水水水水水水水水水水水土土┏┳┳┳┳┳┳穴穴穴穴穴穴穴穴穴穴穴穴穴穴穴穴穴土土穴穴穴穴穴穴穴土土土土土土土土土树树树树树树树树树
道道道道道道道┫┫┣┣穴穴穴穴水水┫土土土土土土土水水水水水圯水水水土土土土土土土土土土土┣穴穴穴穴穴穴穴穴穴穴穴穴穴穴穴穴穴穴穴穴穴穴穴土土穴穴穴穴穴穴穴土土土土土土土土土树树树树树树树树树
道道穴穴穴穴穴┫┫┣┣穴穴穴穴水水┫土土土土土土土水水水水水圯水水水土土土土土土土土土土土┣穴穴穴穴穴穴穴穴穴穴穴穴穴穴穴穴穴穴穴穴穴穴穴土土穴穴穴穴穴穴穴土土┏┲┳┱┓土土树树树树树树树树树
道道穴穴穴穴穴┫┫┣┣穴穴┌┻滝滝┛土土水水水水水水水土土土土土土土土土┏┳┳┳┳┳┳┳┳┳穴穴穴穴穴穴穴穴穴穴穴穴穴穴穴穴穴穴穴穴穴穴穴土土穴穴穴穴穴穴穴土土┣┣穴┫┫土土树树树树树树树树树
穴穴穴穴穴穴穴┳┳┳┳穴穴┫土水水土土土水水水水水水水土土土土土土土土土┣穴穴穴穴穴穴穴穴穴穴穴穴穴穴穴穴穴穴穴穴穴穴穴穴穴穴穴穴飾飾飾飾土土飾飾飾飾穴穴穴土土┣┣穴┫┫土土树树树树树树树树树
穴穴穴穴穴穴穴穴穴穴┌┻║┛土水水土土土水水┏┳┳┳┳┳┳┳┳┳┳┳┳┳┳穴穴穴穴穴穴穴穴穴穴穴穴穴穴穴穴穴穴穴穴穴穴穴穴穴穴穴穴無無门無土土無门無無穴穴穴土土┣┗┻┛┫土土树树树树树树树树树
穴穴穴穴穴穴穴穴穴穴┫土土土土水水圯水水水水┣穴穴穴穴穴穴穴穴穴穴穴穴穴穴穴穴穴穴穴穴穴穴穴穴树树树树树树树树树树树树树树树树树树树树土土土土土土土土土土土土土┗┻┻┻┛土土树树树树树树树树树
穴穴穴穴穴穴穴穴穴穴┫土土土土水水圯水水水水┣穴穴穴穴穴穴穴穴穴穴穴穴穴穴穴穴穴穴穴穴穴穴树树树树土無土树树树树树树树草草草草草草树树土土土土土土土土土土土土土树树草草树土树树树树树树树树树树
穴穴穴穴穴穴穴穴穴穴┫土土土土土土土┏┳┳┳┳穴穴穴穴穴穴穴穴穴穴穴穴穴穴穴穴穴穴穴穴树树树树树树李土土土李树树树树草树草草稂稂草树草土土树树树树树树树树树树树树树草草草土草草草草草树树树树树
穴穴穴穴穴穴穴穴穴穴┫土土土土土土土┣穴穴穴穴穴穴穴穴穴穴穴穴穴穴穴穴穴穴穴穴穴穴树树树树树树树土李土土李土飾飾飾飾草草草树稂草稂稂稂草稂树┏┳┳┳┳┳┓树树树树树草草树土树草树草树草草树树树
穴穴穴穴穴穴穴穴穴穴┳┳┳┳┳┳┳┳┳穴穴穴穴穴穴穴穴穴穴穴穴穴穴穴穴穴穴穴穴树树树树树树树树树李水水土树土飾飾飾飾草草稂草稂稂树稂草稂稂树┣┏┳┳┳┓┫树树树树树草草草土土土土土草草草草树树
穴穴穴穴穴穴穴穴穴穴穴穴穴穴穴穴穴穴穴穴穴穴穴穴穴穴穴穴穴穴穴穴穴穴穴穴穴树树树树树树树树树树树土水水土無土無無無無草草草草稂草草树树树树树┣┣穴穴穴┫┫树树树树树草草树草树草树土树草草草草树
穴穴穴穴穴穴穴穴穴穴穴穴穴穴穴穴穴穴穴穴穴穴穴穴穴穴穴穴穴穴穴穴穴穴穴树树树树树树树树树树树树树李土土土土土無门無無草草树树稂稂树树树树树树┣┣穴水穴┫┫树树树树树树草草草草草草土草草草草草草
穴穴穴穴穴穴穴穴穴穴穴穴穴穴穴穴穴穴穴穴穴穴穴穴穴穴穴穴穴穴穴穴树树树树树树树树树树树树树树树树树土土土土李土土土草草草树树树树树稂稂草稂树┣┗┻滝┻┛┫树树树树树树草草草草草树土树草草草草草
穴穴穴穴穴穴穴穴穴穴穴穴穴穴穴穴穴穴穴穴穴穴穴穴穴穴穴穴穴穴穴穴穴穴穴树树树树树树树树树树树树树树李水水土土土土土土草树草稂树树稂树稂稂稂树┣穴穴水穴穴┫树树树树树树树草草草草草土草草草草草草
穴穴穴穴穴穴穴穴穴穴穴穴穴穴穴穴穴穴穴穴穴穴穴穴穴穴穴穴穴穴穴穴穴穴穴穴穴穴穴树树树树树树树树树树無水水土树树树树土土土草草稂稂稂稂稂草稂草┣穴穴水穴穴┫树树树树树树树树草草草树土树草树草树草
石穴穴穴穴穴穴穴穴穴穴穴穴穴穴穴穴穴穴穴穴穴穴穴穴穴穴穴穴穴穴穴穴穴穴穴穴穴穴穴穴穴穴树树树树树树树树树树树树树树树树草草草草稂稂树稂稂稂稂┗┻┻滝┻┻┛树树树树树树树树草草草草土土土土土土土
石石穴穴穴穴穴穴穴穴穴穴穴穴穴穴穴穴穴穴穴穴穴穴穴穴穴穴穴穴穴穴穴穴穴穴穴穴穴穴穴穴穴穴穴穴穴树树树树树树树树树树树树树树树树树树草树草草稂树树树水树树树树树树树树树树树草草草树草树草树草树土
