石石石石石石石石石石石石石石石石石石石石石石石石石石石石石石石石石石石石石石石石石石石石石石石石石石石石石石石石石石石石石石┫┫┳┳┳┓水水水水水圯水水水水水┣树树树树树树道┏┳┳┳┳┳┳┳┳
石石石石石石石石石石石石石石石石石石石石石石石石石石石石石石石石石石石石石石石石石石石石石石石石石石石石石石石石石石石石石石┫┫穴穴穴┫水水水水水圯水水水水水┣树树树树树树道┣树树树树树树树树
石石石石石石石石石石石石石石石石石石石石石石石石石石石石石石石石石石石石石石石石石石石石石石石石石石石石石石石石石石石石石石┫┫穴穴穴┳┳┳┳┳┳圯┳┳┓水水┣畑畑畑畑畑畑道┣树树树树树树树树
石石石石石石石石石石石石石石石石石石石石石石石石石石石石石石石石石石石石石石石石石石石石石┌┻┻┻┻┻┻┻┻┻┻┻┻┻┻┻┻┛┫穴穴穴穴穴穴穴穴穴穴穴穴┫水水┣畑畑畑畑畑畑道┣树树树树树树树树
石石石石石石石石石石石石石石石石石石石石石石石石石石石石石石石石石石石石石石石石石石石石石┫┌┻┻┻┻┻┻┻┻┻┻┻┻┻┻┻┻┛穴穴穴穴穴穴穴穴穴穴穴穴┫水水┣畑畑畑畑畑畑道┣树树树树树树树树
石石石石石石石石石石石石石石石石石石石石石石石石石石石石石石石石石石石石石石石石石石石石石┫┫穴穴穴┌┻┻┻┻┻┻┻┻┻┻┻┻┻┻┻┻┻┻┻┻┻┻┻圯┻┛水水┣畑畑畑畑畑畑道┣树树树树树树树树
石石石石石石石石石石石石石石石石石石石石石石石石石石石石石石石石石石石石石石石石石石石石石┫┫穴穴穴┫树花土土李树飾飾飾飾飾飾水水水水水水水水水水水圯水水水水┣畑畑畑畑畑畑道┣树树树树树树树树
石石石石石石石石石石石石石石石石石石石石石石石石石石石石石石石石石石石石石石石石石石石石石┫┫穴穴穴┫花土李树土土無门飾飾飾飾水水水水水水水水水水水圯水水水水┣畑畑畑畑畑畑道┣树树树树树树树树
石石石石石石石石石石石石石石石石石石石石石石石石石石石石石石石石石石石石石石石石石石石┌┻┛┫穴穴穴┫树树土李土土土土無無無無水水土土土土土┏┳┳┳圯┳┳┳┳┳土土飾飾飾飾道┣树树树树树树树树
石石石石石石石石石石石石石石石石石石石石石石石石石石石石石石石石石石石石石石石石石石石┫穴穴┫穴穴穴┫树树树树土土树树無门学無水水土土土土土┣土土土道土土土土土土土無门無無道┣树树树树树树树树
石石石石石石石石石┌┻┻┻┻┻┻┻┻┻┻┻┻┻┻┻┻┐石石石石石石石石石石石石石穴穴穴┫穴穴┫穴穴穴─土树树树树树土道道道土土水水土土土土土┣土道道道道道道道道道道道道道道道┗┐石石石石石石石
石石石石石石石石石┫┌┻┻┻┻┻┻┻┻┻┻┻┻┻┻┐┣石石石石石石石石石石石穴穴穴穴穴┫穴穴─穴穴穴┫土土土土土土土道飾飾飾飾水水飾飾飾飾土┣土道土土土土土土土土土土土土土土土┣石石石石石石石
石石石石石石石石石┫┫道道道道道道道道道道道道道道┣┗┻┻┻┻┻┻┻┻┻┻┻┻┻┻┻┻┛穴穴┫穴穴穴┫土土土土土土土道飾飾飾飾水水飾飾飾飾土┣土道土┏┳┳┳┳┓土树土树土土树土┣石石石石石石石
石石石石石石石石石┫┫道道道道道道道道道道道道道道┗┻┻┻┻┻┻┻┻┻┐穴穴穴穴穴穴穴穴穴穴┫穴穴穴┳┳┳┳┳┳┳┓道無無無無水水無無無無土┣土道土┣石石石石┫树树土土土树土土┣石石石石石石石
石石石┌┻┻┻┻┻┛┫道道┏┳┳┳┳┳┳┳┳┓道道道道道道道道道道道道═穴穴穴穴穴穴穴穴穴穴┫┏┳┓穴飾飾飾飾飾飾┫道無门買無水水無门館無土┣土道土┣石石石石┳┳┳┓土土土土树┣石石石石石石石
石石石┫┌┻┻┻┻┻┛道道┣穴穴穴穴穴穴穴穴┫道道道道道道道道道道道道┣穴穴穴穴穴穴穴穴穴穴┫┫┏┱┓飾飾飾飾飾飾┫道道道道道橋橋道道道道道═道道土┣石石石石石石石┳┳┳┳┳┳┳石石石石石石石
石石石┫┫道道道道道道道道┣穴穴穴穴穴穴穴穴┫穴穴┏┲┲┲┳┳┱┳┳┳┳┱┳┓穴穴穴穴穴穴┌┛┫┗┛┫無無無無無無┫飾飾飾飾道水水土土土土道┣土土土┣石石石石石石石石石石石石石石石石石石石石石
石石石┫┫道道道道道道道道┣穴穴穴穴穴穴穴穴┫穴穴┣┣┣┣穴穴┫穴穴穴穴┫穴┫穴穴穴穴穴穴┫穴┗┻┻┛無無门競無無┫無门無無道水水飾飾飾飾道┣┏┳┳┳石石石石石石石石石石石石石石石石石石石石石
石石石┫┫道道┌┻┻┻┻┐┣穴穴穴穴穴穴穴穴┫穴穴┣┣┣┣穴穴┳┳┓穴穴┫穴─穴穴穴穴穴穴┫┌┻┻┻┻┻┻║┻┻┻┛土道道道道水水無门無無道┣┣穴穴穴石石石石石石石石石石石石石石石石石石石石石
石石石┫┫道道┫┌┻┻┐┣┣穴穴穴水水穴穴穴┫穴穴┣┣┣┣穴穴穴穴─穴穴┫穴┫穴穴穴穴穴穴┫┫水水水水水水圯水水水水水水水水圯水水土道道道道┣┣穴穴穴石石石石石石石石石石石石石石石石石石石石石
石石石┫┫道道┫┫穴穴┣┣┣穴穴穴水水穴穴穴┫穴穴┣┣┣┗┻┻┻┻┛穴穴─穴┫┌┻┻┻┻┻┛┫水水水水水水圯水水水水水水水水圯水水土┏┳┳┳┳┣穴穴穴穴穴穴穴穴石石石石石石石石石石石石石石石石
石石石┫┫道道┫┫穴穴┣┣┗┻║┻滝滝┻┻┻┛穴穴┣┣┗┻┻┻┻┻┻┻┻┛穴┫┫┌┻┻┻┻┻┛水水土土土土土土土土土土土土土土土土土┣┏┳┳┳┳穴穴穴穴穴穴穴穴石石石石石石石石石石石石石石石石
石石石┫┫道道┫┫穴┏┳┣穴穴穴穴水水穴穴穴穴穴穴┣┗┻┻┻┻┻┻┻┻┻┻┻┛┫┫水水水水水水水水土土土土土土土土土土土土土土土土土══土土土穴穴穴穴穴穴穴穴穴石石石石石石石石石石石石石石石石
石石石┫┫道道┫┫穴═穴┣穴穴水水水水穴穴穴穴穴穴┗┻┻┻┻┻┻┻┻┻┻┻┻┻┛┫水水水水水水水水土土┏┳┳┳┳┳┳┳┳┳┳┳┳┳┳┳┣土土土穴穴穴穴穴穴穴穴穴石石石石石石石石石石石石石石石石
石石石石石道道┫┫穴┣穴═穴穴水水水水穴穴穴┌┻┻┻┻┻┻┻┻┻┻┻┻┻┻┻┻┻┛水水土土土土土土土土┣┳┳┳┳┳┳┳┳┳┳┳┳┳┳┳┳穴穴穴穴穴穴穴穴穴穴穴穴石石石石石石石石石石石石石石石石
石石石石石道道┫┫┏┳穴┣穴穴水水穴穴穴穴穴┫土土土土土土土土土水水水水水水水水水水水土土土土土土土土┣穴穴穴穴穴穴穴穴穴穴穴穴穴穴穴穴穴穴穴穴穴穴穴穴穴穴穴穴石石石石石石石石石石石石石石石石
道道道道道道道┫┫┣┏┳┳穴穴水水┌┻┻┻┻┛土土土土土土土土土水水水水水水水水水水水土土┏┳┳┳┳┳┳穴穴穴穴穴穴穴穴穴穴穴穴穴穴穴穴穴穴穴穴穴穴穴穴穴穴穴穴石石石石石石石石石石石石石石石石
道道道道道道道┫┫┣┣穴穴穴穴水水┫土土土土土土土水水水水水圯水水水土土土土土土土土土土土┣穴穴穴穴穴穴穴穴穴穴穴穴穴穴穴穴穴穴穴穴穴穴穴穴穴穴穴穴穴穴穴穴穴穴道石石石石石石石石石石石石石石石
石石石石石石石┫┫┣┣穴穴穴穴水水┫土土土土土土土水水水水水圯水水水土土土土土土土土土土土┣穴穴穴穴穴穴穴穴穴穴穴穴穴穴穴穴穴穴穴穴穴穴穴穴穴穴穴穴穴穴穴穴穴穴道道石石石石石石石石石石石石石石
石石石石石石石┫┫┣┣穴穴┌┻滝滝┛土土水水水水水水水土土土土土土土土土┏┳┳┳┳┳┳┳┳┳穴穴穴穴穴穴穴穴穴穴穴穴穴穴穴穴穴穴穴穴穴穴穴穴穴穴穴穴穴穴穴穴穴穴道道道石石石石石石石石石石石石石
石石石石石石石┳┳┳┳穴穴┫土水水土土土水水水水水水水土土土土土土土土土┣穴穴穴穴穴穴穴穴穴穴穴穴穴穴穴穴穴穴穴穴穴穴穴穴穴穴穴穴穴穴穴穴穴穴穴穴穴穴穴穴穴穴穴道道道道石石石石石石石石石石石石
石石石石石石石石石石┌┻║┛土水水土土土水水┏┳┳┳┳┳┳┳┳┳┳┳┳┳┳穴穴穴穴穴穴穴穴穴穴穴穴穴穴穴穴穴穴穴穴穴穴穴穴穴穴穴穴穴穴穴穴穴穴穴穴穴穴穴穴穴穴穴道道道道道石石石石石石石石石石石
石石石石石石石石石石┫土土土土水水圯水水水水┣石石石石石石石石石石石石石石石石石石石石石石石石石石石石石石石石石石石石道道道道石石石石石石石石石石石石石石石石石石道道道道道石石石石石石石石石石
石石石石石石石石石石┫土土土土水水圯水水水水┣石石石石石石石石石石石石石石石石石石石石石石石石石石石石石石石石石石石石道道道石石石石石石石石石石石石石石石石石石石石道道道道道石石石石石石石石石
石石石石石石石石石石┫土土土土土土土┏┳┳┳┳石石石石石石石石石石石石石石石石石石石石石石石石石石石石石石石石石石石道道道道石石石石石石石石石石石石石石石石石石石石石道道道道道石石石石石石石石
石石石石石石石石石石┫土土土土土土土┣石石石石石石石石石石石石石石石石石石石石石石石石石石石石石石石石石石石石石石石道道道道石石石石石石石石石石石石石石石石石石石石石石道道道道道石石石石石石石
石石石石石石石石石石┳┳┳┳┳┳┳┳┳石石石石石石石石石石石石石石石石石石石石石石石石石石石石石石石石石石石石石石道道道道石石石石石石石石石石石石石石石石石石石石石石石石道道道道道石石石石石石
石石石石石石石石石石石石石石石石石石石石石石石石石石石石石石石石石石石石石石石石石石石石石石石石石石石石石石石石石道道道道石石石石石石石石石石石石石石石石石石石石石石石石石道道道道道石石石石石
石石石石石石石石石石石石石石石石石石石石石石石石石石石石石石石石石石石石石石石石石石石石石石石石石石石石石石石石石道道道石石石石石石石石石石石石石石石石石石石石石石石石石石石道道道道道石石石石
石石石石石石石石石石石石石石石石石石石石石石石石石石石石石石石石石石石石石石石石石石石石石石石石石石石石石石石石道道道道石石石石石石石石石石石石石石石石石石石石石石石石石石石石道道道道道石石石
石石石石石石石石石石石石石石石石石石石石石石石石石石石石石石石石石石石石石石石石石石石石石石石石石石石石石石石石道道道道石石石石石石石石石石石石石石石石石石石石石石石石石石石石石道道道道道石石
石石石石石石石石石石石石石石石石石石石石石石石石石石石石石石石石石石石石石石石石石石石石石石石石石石石石石石石道道道道石石石石石石石石石石石石石石石石石石石石石石石石石石石石石石石道道道道道石
石石石石石石石石石石石石石石石石石石石石石石石石石石石石石石石石石石石石石石石石石石石石石石石石石石石石石石石道道道道石石石石石石石石石石石石石石石石石石石石石石石石石石石石石石石石道道道道道
石石石石石石石石石石石石石石石石石石石石石石石石石石石石石石石石石石石石石石石石石石石石石石石石石石石石石石石道道道石石石石石石石石石石石石石石石石石石石石石石石石石石石石石石石石石石道道道道
