穴穴穴水水┫土土土土土土土水水水水水圯水水水土土土土土土土土土土土┣穴穴穴穴穴穴穴穴穴穴穴穴穴穴穴穴穴穴穴穴穴穴穴土土穴穴穴穴穴穴穴土
穴┌┻滝滝┛土土水水水水水水水土土土土土土土土土┏┳┳┳┳┳┳┳┳┳穴穴穴穴穴穴穴穴穴穴穴穴穴穴穴穴穴穴穴穴穴穴穴土土穴穴穴穴穴穴穴土
穴┫土水水土土土水水水水水水水土土土土土土土土土┣穴穴穴穴穴穴穴穴穴穴穴穴穴穴穴穴穴穴穴穴穴穴穴穴穴穴穴穴飾飾飾飾土土飾飾飾飾穴穴穴土
║┛土水水土土土水水┏┳┳┳┳┳┳┳┳┳┳┳┳┳┳穴穴穴穴穴穴穴穴穴穴穴穴穴穴穴穴穴穴穴穴穴穴穴穴穴穴穴穴無無门無土土無门無無穴穴穴土
土土土水水圯水水水水┣穴穴穴穴穴穴穴穴穴穴穴穴穴穴穴穴穴穴穴穴穴穴穴穴树树树树树树树树树树树树树树树树树树树树土土土土土土土土土土土土
土土土水水圯水水水水┣穴穴穴穴穴穴穴穴穴穴穴穴穴穴穴穴穴穴穴穴穴穴树树树树土無土树树树树树树树草草草草草草树树土土土土土土土土土土土土
土土土土土土┏┳┳┳┳穴穴穴穴穴穴穴穴穴穴穴穴穴穴穴穴穴穴穴穴树树树树树树李土土土李树树树树草树草草稂稂草树草土土树树树树树树树树树树
土土土土土土┣穴穴穴穴穴穴穴穴穴穴穴穴穴穴穴穴穴穴穴穴穴穴树树树树树树树土李土土李土飾飾飾飾草草草树稂草稂稂稂草稂树┏┳┳┳┳┳┓树树
┳┳┳┳┳┳┳穴穴穴穴穴穴穴穴穴穴穴穴穴穴穴穴穴穴穴穴树树树树树树树树树李水水土树土飾飾飾飾草草稂草稂稂树稂草稂稂树┣┏┳┳┳┓┫树树
穴穴穴穴穴穴穴穴穴穴穴穴穴穴穴穴穴穴穴穴穴穴穴穴穴树树树树树树树树树树树土水水土無土無無無無草草草草稂草草树树树树树┣┣穴穴穴┫┫树树
穴穴穴穴穴穴穴穴穴穴穴穴穴穴穴穴穴穴穴穴穴穴穴树树树树树树树树树树树树树李土土土土土無门無無草草树树稂稂树树树树树树┣┣穴水穴┫┫树树
穴穴穴穴穴穴穴穴穴穴穴穴穴穴穴穴穴穴穴穴树树树树树树树树树树树树树树树树树土土土土李土土土草草草树树树树树稂稂草稂树┣┗┻滝┻┛┫树树
穴穴穴穴穴穴穴穴穴穴穴穴穴穴穴穴穴穴穴穴穴穴穴树树树树树树树树树树树树树树李水水土土土土土土草树草稂树树稂树稂稂稂树┣穴穴水穴穴┫树树
穴穴穴穴穴穴穴穴穴穴穴穴穴穴穴穴穴穴穴穴穴穴穴穴穴穴穴树树树树树树树树树树無水水土树树树树土土土草草稂稂稂稂稂草稂草┣穴穴水穴穴┫树树
穴穴穴穴穴穴穴穴穴穴穴穴穴穴穴穴穴穴穴穴穴穴穴穴穴穴穴穴穴穴穴树树树树树树树树树树树树树树树树草草草草稂稂树稂稂稂稂┗┻┻滝┻┻┛树树
穴穴穴穴穴穴穴穴穴穴穴穴穴穴穴穴穴穴穴穴穴穴穴穴穴穴穴穴穴穴穴穴穴穴穴树树树树树树树树树树树树树树树树树树草树草草稂树树树水树树树树树
┳┳┳┳┳┳┳┳┳┳┳┳┳┳┳┳┳┳┳┳┳┳┳┳┳┳┳┳┳┳┳┳┳┳┳┳┳┳┳┳┳┳┳┳┳┳┳┳┳┳┳┳┓草草草草稂树树树水树树树树树
穴穴穴穴穴穴穴穴穴穴穴穴穴穴穴穴穴穴穴穴穴穴穴穴穴穴穴穴穴穴穴穴穴穴穴穴穴穴穴穴土土土土土土土土土土土土┫土草草土稂树树树水树树树树树
穴穴穴穴穴穴穴穴穴穴穴穴穴穴穴穴穴穴穴穴穴穴穴穴穴穴穴穴穴穴穴穴穴穴穴穴穴穴穴穴土土土土土土土土土土土土─土土土草稂水水水水树树树树树
穴穴穴穴穴穴穴穴穴穴穴穴穴穴穴穴穴穴穴穴穴穴穴穴穴穴穴穴穴穴穴穴穴穴穴穴穴穴穴穴土土树树树树树树树树树树┫树稂稂稂稂水树树树树树树树树
穴穴穴穴穴穴穴穴穴穴穴穴穴穴穴穴穴穴穴穴穴穴穴穴穴穴穴穴穴穴穴穴穴穴穴穴穴穴穴穴土土水水水水水水水水水树┫树树稂水水水树树树树树树树树
穴穴穴穴穴穴穴穴穴穴穴穴穴穴穴穴穴穴穴穴穴穴穴穴穴穴穴穴穴穴穴穴穴穴穴穴穴穴穴穴土土水水水水水水水水水树┫树树水水树树树树树树树树树树
穴穴穴穴穴穴穴穴穴穴穴穴穴穴穴穴穴穴穴穴穴穴穴穴穴穴穴穴穴穴穴穴穴穴穴穴穴穴穴穴土土水水树树树树树水水树┫树树水树树树树树树树树树树树
穴穴穴穴穴穴穴穴穴穴穴穴穴穴穴穴穴穴穴穴穴穴穴穴穴穴穴穴穴穴穴穴穴穴穴穴穴穴穴穴土土水水树┌┻┻┻滝滝┻┛树树水树树树树树树树树树树树
穴穴穴穴穴穴穴穴穴穴穴穴穴穴穴穴穴穴穴穴穴穴穴穴穴穴穴穴穴穴穴穴穴穴穴穴穴穴穴穴土土水水树┫树树树水水树树树树水树树树树树树树树树树树
穴穴穴穴穴穴穴穴穴穴穴穴穴穴穴穴穴穴穴穴穴穴穴穴穴穴穴穴穴穴穴穴穴穴穴水水水水水圯圯水水树┫树树树水水水水水水水树树树树树树树树树树树
穴穴穴穴穴穴穴穴穴穴穴穴穴穴穴穴穴穴穴穴穴穴穴穴穴穴穴穴穴穴穴穴穴穴穴水水水水水圯圯水水树┫树树树水水水水水水水树树树树树树树树树树树
穴穴穴穴穴穴穴穴穴穴穴穴穴穴穴穴穴穴穴穴穴穴穴穴穴穴穴穴穴穴穴穴穴穴穴水水草草草草草草草草┫树树树树树树树树水水水水水水水水水树树树树
┳┳┳┳┳┳┳┳┳┳┳┳┳┳┳┳┳┳┳┳┳┳┳┳┳┳┳┳┓穴穴穴穴穴穴水水土土草草草草树树┫树树树树树树树树水水水水水水水水水树树树树
穴穴穴穴穴穴穴穴穴穴穴穴穴穴穴穴穴穴穴穴穴穴穴穴穴穴穴岩┫穴穴穴穴水水水水土土土草草树树树┫树树树树树树树树树树树树树树树水水水水水水
┳┳┳┳┳┳┳┳┳┳┳┳┳┳┳┳┳┳┳┳┳┳┳┳┳┓穴穴┫穴穴穴穴水水水水土树土土土树树树┫树树树树树树树树树树树树树树树水水水水水水
穴穴穴穴穴穴穴穴穴穴穴穴穴穴穴穴穴穴穴穴穴穴穴穴穴┫穴穴┫穴穴穴穴水水土树土土土土土树树树┫树树树树树树树树树树树树树树树树树树树树树
穴穴穴穴穴穴穴穴穴穴穴穴穴穴穴穴穴穴穴穴穴穴穴穴穴┫穴穴┫穴穴穴穴水水土土土草草草草树树树┫树树树树树树树树树树树树树树树树树树树树树
穴穴穴穴穴穴穴穴穴┌┻┻┻┻┻┻┻┻┻┻┻┻┐岩穴┫穴穴┫穴穴穴穴水水草草草草草草树树树树┫树树树树树树树树树树树树树树树树树树树树树
穴穴穴穴穴穴穴穴穴┫穴穴穴穴穴穴穴穴穴穴穴穴┗┻┻┛穴穴┫水水水水水水草草草草草树树树树树┫树树树树树树树树树树树树树树树树树树树树树
穴穴穴穴穴穴穴穴穴┫穴穴穴穴穴┌┻┻┻┻║┻┻┻┻┻┻┻┛水水水水水水草草草草土树树树树树┫树树树树树树树树树树树树树树树树树树树树树
穴穴穴穴穴穴穴穴穴┫穴穴穴穴穴┫树树树树土土土树土土土水水水水土草草草草土土树土树树树树树┫树树树树树树树树树树树树树树树树树树树树树
穴穴穴穴穴穴穴穴穴┫穴穴穴穴穴┫树树树树土树土土土树土水水水水土土土土土土土土土树树树树树┫树树树树树树树树树树树树树树树树树树树树树
穴穴穴穴穴穴穴穴穴┫穴穴┌┻┻┛树树树树土土土树土土土水水草草土土土土树土土土土树树树树树┫树树树树树树树树树树树树树树树树树树树树树
穴穴穴穴穴穴穴穴穴┫穴穴┫树树树树树树树树土飾飾飾飾土水水草草草土土土土土树土土树树树树树┫树树树树树树树树树树树树树树树树树树树树树
穴穴穴穴穴穴穴穴穴┫穴穴┫树树树树树树树树土飾飾飾飾土水水草草草草草土土土土土树树树树树树┫树树树树树树树树树树树树树树树树树树树树树
穴穴穴穴穴穴穴穴穴┫穴穴┫畑畑畑社畑畑畑树土無無無無土水水草草草草草草草土土土土树树树树树┫树树树树树树树树树树树树树树树树树树树树树
穴穴穴穴穴穴穴穴穴┫穴穴┫畑畑畑畑畑畑畑树土無门無無土水水土草草草草草草草土土土树树树树树┫树树树树树树树树树树树树树树树树树树树树树
穴穴穴穴穴穴穴穴穴┫穴穴┫畑畑畑畑畑畑畑土土土土土土土橋橋土土土草草草草草草草土树树树树树┫树树树树树树树树树树树树树树树树树树树树树
穴穴穴穴穴穴穴穴穴┫穴穴┫畑畑畑畑畑畑畑树土土土土土树水水土土土土土土土草草草草树树树树树┫树树树树树树树树树树树树树树树树树树树树树
穴穴穴穴穴穴穴穴穴┫穴穴┫畑畑畑畑畑畑畑树土土土土土树水水水土土土土土土土土草草树树树树树┫树树树树树树树树树树树树树树树树树树树树树
穴穴穴穴穴穴穴穴穴┳┓穴┫畑畑畑畑畑畑畑树树树树树树树水水水水土土土土土树土土草树树树树树┫树树树树树树树树树树树树树树树树树树树树树
穴穴穴穴穴穴穴穴穴岩┫穴┫畑畑畑畑畑畑畑树树树树树树水水水水水土土土土土土土土土树树树树树┳┳┳┳┳┳┳┳┳┳┳┳┳┳┳┳┳┳┳┳┳┳
穴穴穴穴穴穴穴穴穴穴┫穴┫树树树树树树树树树树树树树水水水水水土土树土树土土树土树树树树树树树树树树树树树树树树树树树树飾飾飾飾树树树
水水水水水水水水水穴┫穴┫树树树树树树树树树树树树水水水水水土土土土土土土草草草树树树树树树树树草草草水水水水草草草草树飾飾飾飾畑畑畑
水水水水水水水水水穴┫岩┫树树树树树树树树水水水水水水水水水土土土土土树草草草草树树树树树树树树树树草草草草水草草草草树無無無無畑畑畑
水穴穴穴穴穴穴水水穴┫┌┛树树树树树树树树水水水水水水水水土土草草草草草草草草树树树树树树树树水水水水水草草水草草草草树無门無無畑畑畑
水穴┌┻┻┻┻滝滝┻┛┫水水水水水水水水水水水树树树树草草草草草草草草草草草草树树树树树树树树水花草花水草草橋草树草草草花土土土畑畑畑
水穴┫穴穴穴穴水水穴穴┫水水水水水水水水水水水树树树树草草草草草草草草土土土树树树树树树树树树水草土草水水水水草树树草草土土树土畑畑畑
水穴┫穴┌┻┻滝滝┻┻┛水水树树树树树树树树树树树树树草草草草土土土土土土树树树树树树树树树树水花草草草草草草草树树草草土土土土畑畑畑
水穴┫穴┫石石水水水水水水水树树树树树树树树树树树树树草草草土土土土土土土树树树树树树树树树树水水水草草草草草树树草草草土土土土┌┻┻
水穴┫穴┫石石水水水水水水水树树┏┳┳┳┳┳┳┳┓树树树树土土土土土土土树树树树树树树树树草树树树水草草草草树树草草草土土土土树┫┌┻
水穴┫穴┫石石石石石石石石石树树┣土土土草草草树┫树树树树树土土土土土树树树树树树树树树树草草草草水草草树树树草草草草土土土┌┻┛┫┌
水穴┫穴┫石石石石石石石石石树树┣草草土土飾草树┫┌┻┻┻┻┻┻║║┻┻┻┻┻┻┻┻┻┻┐草草草草水草草树树树草草草草土土土┫┌┻┛┫
水穴┫穴┫石石石石石石石石石树树┣草树草飾飾飾树┫┫土土土土土土土土土土土土土土土土土土┣树草草水水草树树┌┻┻┻┻┻┻║┻┛┫┌┻┛
水穴┫穴┫石石石石石石石石石树树┣草树飾飾無飾飾┫┫土土土土土土土土土土土土土土土土土土┣树草草橋草草树树┫岩穴穴穴穴穴穴穴穴┫┫穴穴
水穴┫穴┫石石石石石石石石石树树┣草草飾無無無飾┫┫土土飾飾飾飾土土飾飾飾飾土土飾飾飾飾┣树树树水水树树树┫┌┻┻┻┻┻║┻┻┛┫穴穴
水穴┫穴┫石石石石石石石石石树树┣树草無無门無無┫┳┓土飾飾飾飾土土飾飾飾飾土土飾飾飾飾┗┻┻┻┻滝┻┻┻┛┫岩穴穴穴穴穴穴穴穴┫穴穴
