???????????????
???????????????
???????????????
???????????????
???????????????
???????????????
???????????????
??????????___??
??????????___??
??_______?___??
??_______?___??
??_______?___??
??___________??
?????^?????????
???????????????