道水水水水水水水土土土土土土树树树树树树树树树树树树树树树树树树树树树树树树树树树树树树树树树树树树树树树树树树树树树树树树树树树树树树树树树树树树树树树树树树树树树树树树树树树树树树树树树树树树树树树树树树树树树树树树树树树树树树树树树树树树树树树树树树树树树树树树树树树树树树树树树树树树树树
道花土树树树树树土树树树树树树树树树树树树树树树树树树树树树树树树树树树树树树树树树树树树树树树树树树树树树树树树树树树树树树树树树树树树树树树树树树树树树树树树树树树树树树树树树树树树树树树树树树树树树树树树树树树树树树树树树树树树树树树树树树树树树树树树树树树树树树树树树树树树树树树树树树树
道土花飾飾飾飾飾土树树树树树树树树树树树树树树树树树树树树树树树树树树树树树树树树树树树树树树树树树树树树树树树树树树树树树树树树树树树树树树树树树树树树树树树树树树树树树树树树树树树树树树树树树树树树树树树树树树树树树树树树树树树树树树树树树树树树树树树树树树树树树树树树树树树树树树树树树树树
道土土飾飾飾飾飾门树树树树树树树树树树树树树树树树树树树树树树树树树树树树树树树树树树树树树树树树树树树树树树树树树树树树树树树树树树树树树树树树树树树树树树树树树树树树树树树树树树树树树树树树树树树树树树树树树树树树树树树树树树树树树树树树树树树树树树树树树树树树树树树树树树树树树树树树树树树
道土飾無無门無無無树树树树树树树树树树树树树树树树树树树树树树树树树树树树树树树树树树树树树树树树树树树树树树树树树树树树树树树树树树树树树树树树树树树树树树树树树树树树树树树树树树树树树树树树树树树树树树树树树树树树树树树树树树树树树树树树树树树树树树树树树树树树树树树树树树树树树树树树树树树
道道道道道道道土土树树树树树树树树树树树树树树树树树树树树树树树树树树树树树树树树树树树树树树树树树树树树树树树树树树树树树树树树树树树树树树树树树树树树树树树树树树树树树树树树树树树树树树树树树树树树树树树树树树树树树树树树树树树树树树树树树树树树树树树树树树树树树树树树树树树树树树树树树树树
道道道道道道道土土树树树树树树树树树树树树树树树树树树树树树树树树树树树树树树树树树树树树树树树树树树树树树树树树树树树树树树树树树树树树树树树树树树树树树树树树树树树树树树树树树树树树树树树树树树树树树树树树树树树树树树树树树树树树树树树树树树树树树树树树树树树树树树树树树树树树树树树树树树树
道道道道道道道土土树树树树树树树树树树树树树树树树树树树树树树树树树树树树树树树树树树树树树树树树树树树树树树树树树树树树树树树树树树树树树树树树树树树树树树树树树树树树树树树树树树树树树树树树树树树树树树树树树树树树树树树树树树树树树树树树树树树树树树树树树树树树树树树树树树树树树树树树树树树
道道道道道道道土土树树树树树树树树树树树树树树树树树树树树树树树树树树树树树树树树树树树树树树树树树树树树树树树树树树树树树树树树树树树树树树树树树树树树树树树树树树树树树树树树树树树树树树树树树树树树树树树树树树树树树树树树树树树树树树树树树树树树树树树树树树树树树树树树树树树树树树树树树树树
树道道道道飾飾飾飾树树树树树树树树树树树树树树树树树树树树树树树树树树树树树树树树树树树树树树树树树树树树树树树树树树树树树树树树树树树树树树树树树树树树树树树树树树树树树树树树树树树树树树树树树树树树树树树树树树树树树树树树树树树树树树树树树树树树树树树树树树树树树树树树树树树树树树树树树树树
树無道無無飾飾飾飾树树树树树树树树树树树树树树树树树树树树树树树树树树树树树树树树树树树树树树树树树树树树树树树树树树树树树树树树树树树树树树树树树树树树树树树树树树树树树树树树树树树树树树树树树树树树树树树树树树树树树树树树树树树树树树树树树树树树树树树树树树树树树树树树树树树树树树树树树树树
树道道道道無無無無树树树树树树树树树树树树树树树树树树树树树树树树树树树树树树树树树树树树树树树树树树树树树树树树树树树树树树树树树树树树树树树树树树树树树树树树树树树树树树树树树树树树树树树树树树树树树树树树树树树树树树树树树树树树树树树树树树树树树树树树树树树树树树树树树树树树树树树水水树树
树道道道道無门無無土土树树树树树树树树树树树树树树树树树树树树树树树树树树树树树树树树树树树树树树树树树树树树树树树树树树树树树树树树树树树树树树树树树树树树树树树树树树树树树树树树树树树树树树树树树树树树树树树树树树树树树树树树树树树树树树树树树树树树树树树树树树树树树树树树树树树树水水水水水
树道道道道道道道道道道道树树树树树树树树树树树树树树树树树树树树树树树树树树树树树树树树树树树树树树树树树树树树树树树树树树树树树树树树树树树树树树树树树树树树树树树树树树树树树树树树树树树树树树树树树树树树树树树树树树树树树树树树树树树树树树树树树树树树树树树树树树树树树树树树树树水水水水水水
土道道道道道道道道道道道树树树树树树树树树树树树树树树树树树树树树树树树树树树树树树树树树树树树树树树树树树树树树树树树树树树树树树树树树树树树树树树树树树树树树树树树树树树树树树树树树树树树树树树树树树树树树树树树树树树树树树树树树树树树树树树树树树树树树树树树树树树树树树树树树树水水水水水水
花道道道道土花土花土道道树树树树树树树树树树树树树树树树树树树树树树树树树树树树树树树树树树树树树树树树树树树树树树树树树树树树树树树树树树树树树树树树树树树树树树树树树树树树树树树树树树树树树树树树树树树树树树树树树树树树树树树树树树树树树树树树树树树树树树树树树树树树树树树树树水水水水水水水
土道道道道花土花土花道道树树树树树树树树树树树树树树树树树树树树树树树树树树树树树树树树树树树树树树树树树树树树树树树树树树树树树树树树树树树树树树树树树树树树树树树树树树树树树树树树树树树树树树树树树树树树树树树树树树树树树树树树树树树树树树树树树树树树树树树树树树树树树树树树树水水水水水水水
道道道道道土土土土標道道树树树树树草草草草树树树树树树树树树树树树树树树树树树树树树树树树树树树树树树树树树树树树树树树树树树树树树树树树树树树树树树树树树树树树树树树树树树树树树树树树树树树树树树树树树树树树树树树树树树树树树树树树树树树树树树树树树树树树树树树树树树树树树树树树水水水水水水水
道道道道道土土土土土道道树树树树树草草草草树树树树树树树树树树树树树树树树树树树树树树树树树树树树树树树树树树树树树树树树树树树树树树树树树树树树树树树树树树树树树树树树树树树树树树树树树树树树树树树树树树树树树树树树树树树树树树树树树树树树树树树树树树树树树树树树树树树树树树树树水水水水水水水
树树树土土土土土土土道道道道土土土土土草草树树树树树树树树树树树树树树树树树树树树树树树树树树树树树树树树树树树树树树树树树树树树树树树树树树树树树树树树树树树树树树树树树树树树树树树树树树树树树树树树树树树树树树树树树树树树树树树树树树树树树树树树树树树树树树树树树树树树树树树树树树水水水水水
树树树土土土土土土土道道道道土土土土土草草树树树树树树树树树树树树树树树树树树树树树树树树树树树树树树树树树树树树树树树树树树树树树树树树树树树树树树树树树树树树树树树树树树树树树树树树树树树树树树树树树树树树树树树树树树树树树树树树树树树树树树树树树树树树树树树树树树树树树树树树树树树水水水水
飾飾树树树树树树树树树树树树树树树树树草草土土土土树树树树树树树树树树树树树树树树树树树树树树树树树树树树树树树树树树树树树树树树树树树树树树树树树树树树树树树树树树树树树树树树树树树树树树树树树树树树树树树树树树树树树树树树树树树树树树树树树树树树树树树树树树树树树树树树树树树树树树树树水水水
無無树树树树树树树树树树树树树树树树树草草土土土土树树树树树树树树树树树树树树树树树树树树树树树树树树树树树树树树树树树树树树树树树树树树树树树树树树树树树树树树树树树树树树树树树树树树树树树树树树树树树树树树树树树树树树树树树树树树树树树树树树树树树树树树树树树树树树树树树树树树树树树树水水水
土土树树树树树树树树树树树树树树树树树草草稂稂土土树树树树树树树树树树树树树树树树树树树树树树树树树树树草草草草草草树树树树树树树树树树树树树树树树树树树树树树树树树树树树树树树树树树树树树树树树树树树树树树树树树树树树树树树树树树树树树树树树树树树树树树树树树树树树树树树树树树树树树树树树水水
土土土树树树树树树树树树树树石石石石石草草稂稂土土树树树树树树树树树树树树树树土草土草土草土草土草土树树草草草草草草树树树树树树树树树树树树树树树树树树树树树树树树树树树树树树树树树树树树树树树树树树树树树树树树树树树树树树树树树树树树树树树树树树树树树树树树树树树树树树树树树树树树树树树树树树
土树树树树树树树树石石石石石石石石石石草草稂稂土土树树树树树树树树树树树树树树土草土草土草土草土草土草草草草树树草草土土树树树树树树树树土土草草树树树树树树树树树树树树树树树树树树树树树树树树树树树树树树树树树树树树树树树树树树树树树树树树树树树树树树树树树树树树树树树树树树树树树树树树树树树树
土树树树树树树树树石石石石石石石石土土土土土土土土树树树树树树树树树树树树树树土草土草土草土草土草土草草草草树树草草土土树树树树树树树树土土草草树树树树树树树树树树树水水水水水水树树树树树树树树树树树树树树树树树树树树树树树树树树树树树树树树树树树树树树树树树树树树树树树树树树树树树树树树树树树
土树树树树树树树树石石石石石石石石土土土土土土土土树树树树树树树树树树树树树树土草土草土草土草土草土草草树树树树树树土土草草土土土土道道道道草草草草草草树树树树树树树水水水水水水树树树树树树树树树树树树树树树树树树树树树树树树树树树树树树树树树树树树树树树树树树树树树树树树树树树树树树树树树树树
树树树树树树树树石石石石石石石石石土土土土树树土土树树树树树树树树树树树树树树土草土草土草土草土草土草草树树树树树树土土草草土土土土道道道道草草草草草草树树树树树树树水水水水水水树树树树树树树树树树树树树树树树树树树树树树树树树树树树树树树树树树树树树树树树树树树树树树树树树树树树树树树树树树树
树树树树树树树树石石石石石石石石石土土草草树树土土树树树树树树树树树树飾飾飾飾土草土草土草土草土草土草草草草土土树树树树草草草草树树土土道道道道草草草草树树树树树树树水水水水水水树树树树树树树树树树树树树树树树树树树树树树树树树树树树树树树树树树树树树树树树树树树树树树树树树树树树树树树树树树树
树树树树树树树石石石石石石石石石石土土草草树树土土树树树树树树树树树树飾飾飾飾土草土草土草土草土草土草草草草土土树树树树草草草草树树土土道道道道草草草草树树树土草土草土草土水水水树树树树树树树树树树树树树树树树树树树树树树树树树树树树树树树树树树树树树树树树树树树树树树树树树树树树树树树树树树树
树树树树树树树石石石石石石石石石石石石草草稂稂稂稂树树树树树树树树树树無無無無土树树树水水水水水水树树树树树树土草草草草土土树树树树树树花土道道草草树树树树树土草土草土草土水水水水水水水树树树树树树树树树树树树树树树树树树树树树树树树树树树树树树树树树树树树树树树树树树树树树树树树树树树树树树树
树树树树树树树石石石石石石石石石石石石草草稂稂稂稂树树树树树树树树树树無门無無土树树树水水水水水水树树树树树树土草草草草土土树树树树树树花土道道草草树树树树树土草土草土草土水水水水水水水树树树树树树树树树树树树树树树树树树树树树树树树树树树树树树树树树树树树树树树树树树树树树树树树树树树树树树树
树树树树树树石石石石石石石石石石石草草草草稂稂稂稂树树树树树树树树土土土土土土土树树树水水水水水水树树树树树树树树树树树树树树树树树草草土土道道土土树树树树树土草土草土草土水水水水水水水水水树树树树树树树树树树树树树树树树树树树树树树树树树树树树树树树树树树树树树树树树树树树树树树树树树树树树树
树树树树树树石石石石石石石石石石石草草草草稂稂稂稂树树树树树树树树土土土土土土土树土土水水水水水水树树树树树树树树树树树树树树树树树草草土土道道土土树树树树树土草土草土草土水水水水水水水水水树树树树树树树树树树土草土草土草土树树树树树树树树树树树树树树树树树树树树树树树树树树树树树树树树树树树树
树树树树树石石石石石石石石石石石石石石草草草草草草草草土土土土道道道道道道道道道無道道土土土土草草草草草草土土無土土花土树树树树草草草草土土道道树树树树树树树土草土草土草土飾飾飾飾水水水水水树树树树树树树树树树土草土草土草土树树树树树树树树树树树树树树树树树树树树树树树树树树树树树树树树树树树树
树树树树树石石石石石石石石石石石石石石草草草草草草草草土土土土道道道道道道道道道無道道土土土土草草草草草草土土無土土花土树树树树草草草草土土道道树树树树树树树土草土草土草土無门無無水水水水水树树树树树树树树树树土草土草土草土树树树树树树树树树树树树树树树树树树树树树树树树树树树树树树树树树树树树
树树树树树石石石石石石石石石石石石石石石石石石石石石石石石石石石石土土土土土土土無道道道道道道道道無道道道道道無道道道道道道道道道道道道道道道道树树树树树树树树树树草草草草土土土土草草树树树树树树树水水水水水水土草土草土草土树树树树树树树树树树树树树树树树树树树树树树树树树树树树树树树树树树树树
树树树树石石石石石石石石石石石石石石石石石石石石石石石石石石石石石無無無土無無無無道道道道道道道道無道道道道道無道道道道道道道無道道道道道道道道树树树树树树树树树树草草草草土土土土草草树树树树树树树水水水水水水土草土草土草土树树树树树树树树树树树树树树树树树树树树树树树树树树树树树树树树树树树树
树树树树石石石石石石石石石石石石石石石石石石石石石石石石石石石石石草草草草草草草草树树土土土土土土無土土草草草草草草土土土土土無土土土土土土道道道道道無道道道道道道草草土土土土土土草草树树树树树树树水水水水水水土草土草土草土树树树树树树树树树树树树树树树树树树树树树树树树树树树树树树树树树树树树
树树树石石石石石石石石石石石石石石石石石石石石石石石石石石石石石石草草草草草草草草树树無無無土無無無土土草草草草草草土土土土土無土土土土土土道道道道道無道道道道道道草草土土土土土土草草树树树树树树树水水水水水水土草土草土草土树树树树树树树树树树树树树树树树树树树树树树树树树树树树树树树树树树树树
树树树石石石石石石石石石石石石石石石石石石石石石石石石石石石石石石石石草草草草草草土土草草土土石石草草草土土石石石石石石石石石石石石石石石石石石草草草草草草草草道道道道道道道道道道道道道道道道道道道草草土土飾飾飾飾草草树树树树树树树树树树树树树树树树树树树树树树树树树树树树树树树树树树树树树树树
树树树树石石石石石石石石石石石石石石石石石石石石石石石石石石石石石石石草草草草草草土土草草土土石石草草草土土石石石石石石石石石石石石石石石石石石草草草草草草草草道道道道道道道道道道道道道道道道道道道草草土土無门無無草草树树树树树树树树树树树树树树树树树树树树树树树树树树树树树树树树树树树树树树树
树树树树石石石石石石石石石石石石石石石石石石石石石石石石石石石石石石石石石草草土土草草土土土土石石石石石石石石石石石石石石石石石石石石石石石石石草草草草草草草草草草草草草草草草草草草草草草草草草道道树树道道道道道道土树树树树树树树树树树树树树树树树树树树树树树树树树树树树树树树树树树树树树树树树
树树树树树石石石石石石石石石石石石石石石石石石石石石石石石石石石石石石石石草草土土草草土土土土石石石石石石石石石石石石石石石石石石石石石石石石石草草草草草草草草草草草草草草草草草草草草草草草草草道道树树道道道道道道土树树树树树树树树树树树树树树树树树树树树树树树树树树树树树树树树树树树树树树树树
树树树树树树石石石石石石石石石石石石石石石石石石石石石石石石石石石石石石石石石石石石石石石石石石石石石石石石石石石石石石石石石石石石石石石石石石石石石石石石石石石石石石石石石石石石石石石石石石石道道草草道道土土土土土树树树树树树树树树树树树树树树树树树树树树树树树树树树树树树树树树树树树树树树树
树树树树树树石石石石石石石石石石石石石石石石石石石石石石石石石石石石石石石石石石石石石石石石石石石石石石石石石石石石石石石石石石石石石石石石石石石石石石石石石石石石石石石石石石石石石石石石石石石道道草草道道土土果土土树树树树树树树树树树树树树树树树树树树树树树树树树树树树树树树树树树树树树树树树
树树树树树树树石石石石石石石石石石石石石石石石石石石石石石石石石石石石石石石石石石石石石石石石石石石石石石石石石石石石石石石石石石石石石石石石石石石石石石石石石石石石石石石石石石石石石石石石石石道道草草道道土土土土土树树树树树树树树树树树树树树树树树树树树树树树树树树树树树树树树树树树树树树树树
树树树树树树树石石石石石石石石石石石石石石石石石石石石石石石石石石石石石石石石石石石石石石石石石石石石石石石石石石石石石石石石石石石石石石石石石石石石石石石石石石石石石石石石石石石石石石石石石石道道草草道道土土土土土树树树树树树树树树树树树树树树树树树树树树树树树树树树树树树树树树树树树树树树树
树树树树树树树树石石石石石石石石石石石石石石石石石石石石石石石石石石石石石石石石石石石石石石石石石石石石石石石石石石石石石石石石石石石石石石石石石石石石石石石石石石石石石石石石石石石石石石石石石道道草草道道树树草草草草草草草草草树树树树树树树树树树树树树树树树树树树树树树树树树树树树树树树树树树
树树树树树树树树树石石石石石石石石石石石石石石石石石石石石石石石石石石石石石石石石石石石石石石石石石石石石石石石石石石石石石石石石石石石石石石石石石石石石石石石石石石石石石石石石石石石石石石石石道道草草道道树树草草草草草草草草草树树树树树树树树树树树树树树树树树树树树树树树树树树树树树树树树树树
树树树树树树树树树石石石石石石石石石石石石石石石石石石石石石石石石石石石石石石石石石石石石石石石石石石石石石石石石石石石石石石石石石石石石石石石石石石石石石石石石石石石石石石石石石石石石石石石石道道道道道道道道道道道道道道道草草树树树树树树树树树树树树树树树树树树树树树树树树树树树树树树树树树树
树树树树树树树树树树石石石石石石石石石石石树树树树树树树树树树树树石石石石石石石石石石石石石石石石石石石石石石石石石石石石石石石石石石石石石石石石石石石石石石石石石石石石石石石石石石石石石石石石道道道道道道道道道道道道道道道草草树树树树树树树树树树树树树树树树树树树树树树树树树树树树树树树树树树
树树树树树树树树树石石石石石石石石石树树树树树树树树树树树树树树树树树树石石石石石石石石石石石石石石石石石石石石石石石石石石石石石石石石石石石石石石石石石石石石石石石石石石石石石石石石石石石石石草草草草草草草树树树树土土道道草草树树树树树树树树树树树树树树树树树树树树树树树树树树树树树树树树树树
树树树树树树树树树石石石石石石石树树树树树树树树树树树树树树树树树树树树树石石石石石石石石石石石石石石石石石石石石石石石石石石石石石石石石石石石石石石石石石石石石石石石石石石石石石石石石石石石石草草草草草草草树树树树土土道道草草树树树树树树树树树树树树树树树树树树树树树树树树树树树树树树树树树树
树树树树树树树树石石石石石石石树树树树树树树树树树树树树树树树树树树树树树树石石石石石石石石石石石石石石石石石石石石石石石石石石石石石石石石石石石石石石石石石石石石石石石石石石石石石石石石石石石石石石石土土土树树石石土土道道草草树树树树树树树树树树树树树树树树树树树树树树树树树树树树树树树树树树
树树树树树树树树石石石石石石石树树树树树树树树树树树树树树树树树树树树树树树树石石石石石石石石石石石石石石石石石石石石石石石石石石石石石石石石石石石石石水水石石石石石石石石石石石石石石石石石石石石石石石土土土树树石石土土道道草草树树树树树树树树树树树树树树树树树树树树树树树树树树树树树树树树树树
树树树树树树树石石石石石石石树树树树树树土土土土土土草草草草树树树树树树树树树树石石石石石石石石石石石石石石石石石石石石石石石石石石石石石石石石石石水水石石石石石石石石石石石石石石石石石石石石石石石石石石石石石石石石土土道道草草树树树树树树树树飾飾飾飾树树树树树树树树树树树树树树树树树树树树树树
石树树树树树树石石石石石石树树树树树树土土飾飾飾飾土草草草草树树树树树树树树树树树石石石石石石石石石石石石石石石石石石石石石石石石石石石石石石石水水石石石石石石石石石石石石石石石石石石石石石石石石石石石石石石石石石石土土道道草草树树树树树树树土飾飾飾飾树树树树树树树树树树树树树树树树树树树树树树
石石树树树树石石石石石石树树树树树树树土土無门無無土土土土土土土树树树树树树树树树树石石石石石石石石石石石石石石石石石石石石石石石石石石石石石水石石石石石石石石石石石石石石石石石石石石石石石石石石石石石石石石石石草草土土道道草草树树树树树树土土無無無無树树树树树树树树树树树树树树树树树树树树树树
石石石树树树石石石石石石树树树树树树树花土土土土土土果土土土土土土树树树树树树树树树树树石石石石石石石石石石石石石石石石石石石石石石石石石石水水石石石石石石石石石石石石石石石石石石石石石石石石石石石石石石石石石石草草土土道道土土树树树树树土土土無门無無飾飾飾飾树树树树树树树树树树树树树树树树树树
石石石石树石石石石石石石树树树树树树土土花土土土土土土土土土土李李树树树树树树树树树树树树石石石石石石石石石石石石石石石石石石石石石石石石水水石石石石石石石石石石石石石石石石石石石石石石石石石石石石石石石石石石石草草土土道道土土树树树树土土土土土道土土無门無無树树树树树树树树树树树树树树树树树树
石石石石石石石石石石石石树树树树树树土土土土土土土土土土土土李李水水水树树树树树树树树树树石石石石石石石石石石石石石石石石石石石石石石石石水石石石石石石石石石石石石石石石石石石石石石石石石石石石石石石石石石石草草草草土土道道土土树树飾飾飾飾土土道道道土土道土土树树树树树树树树树树树树树树树树树草
石石石石石石石石石石石石树树树树树树草草草草土土土土土土水水水水水水水水树树树树树树树树树石石石石石石石石水水水水水石石石石石石石石石石水水石石石石石石石石石石石石石石石石石石石石石石石石石石石石石石石石石石草草草草土土道道土土树树無门無無道道道道道道道道道道土树树树树树树树树树树树飾飾飾飾树土
石石石石石石石石石石石石树树树树树树草草草草草草草草草草水水水水水水水水水水树树树树树树树树石石石石水水水水石石石石水水石石石石石石石石水石石石石石石石石石石石石石石石石石石石石石石石石石石石石石石石石石石石草草草草土土道道道道道道道道道道道土土土土土土土土道土土土土树树树树树树树树無门無無树土
石石石石石石石石石石石石树树树树树树草草草草草草草草草草水水水水水水水水水水水水水树树水水水水水水水水石石石石石石石石水水水石石石石石石水石石石石石石石石石石石石石石石石石石石石石石石石石石石石石石石石石石石草草草草土土道道道道道道道道道道道土水水水水水水土道土土土土树树树树树树树树土土土土树土
石石石石石石石石石石石石树树树树树树草草草草草草草草草水水水水水水水水水水水水水水水水树树树石石石石石石石石石石石石石石石石水水水石石水石石石石石石石石石石石石石石石石石石石石石石石石石石石石石石石石石石草草草草草草草草道道土土树土土土道道道土水土水水水水土道道道道道道道道道道道土土土土土土土土
石石石石石石石石石石石石树树树树树树树草草草草草草草草水水水水水水水水水水水水水水水水水树树石石石石石石石石石石石石石石石石石石石水水石石石石石石石石石石石石石石石石石石石石石石石石石石石石石石石石石石石草草草草草草草草道道土土树树土树土道道土水土土水水水土道道道道道道道道道道道土土土土土土土土
石石石石石石石石石石石石树树树树树树树草草草草草草草草水水水水水水水水水水水水水水水水水水树石石石石石石石石石石石石石石石石石石石石石石石石石石石石石石石石石石石石石石石石石石石石石石石石石石石石石石草草草草土土土土道道道道树树树树树土土土道土水水水水水水土道土土树树树树树树树树树树树树树树树树
石石石石石石石石石石石石树树树树树树树草草草草草草草草水水水水水水水水水水水水水水水水水水树石石石石石石石石石石石石石石石石石石石石石石石石石石石石石石石石石石石石石石石石石石石石石石石石石石石石石石草草草草土土土土道道道道树树树树土土花土道土土土土土土土土道土树树树树树树树树树树树树树树树树树
石石石石石石石石石石石石树树树树树树树草草草草草草草草草水水水水水水水水水水水水水水水水水树石石石石石石石石石石石石石石石石石石石石石石石石石石石石石石石石石石石石石石石石石石石石石石石石石石石石树树草草稂稂土土树树树树草草树树树树树花土花道道道道道道道道道道树树树树树树树树树树树树树树树树树树
石石石石石石石石石石石石石树树树树树树树草草草草草草草草水水水水水水水水水水水水水水水水树树石石石石石石石石石石石石石石石石石石石石石石石石石石石石石石石石石石石石石石石石石石石石石石石石石石石石树树草草稂稂土土树树树树草草树树树树树土花土道道道道道飾飾飾飾树树树树树树树树树树树树树树树树树树树
石石石石石石石石石石石石石树树树树树树树草草草草草草草草草水水水水水水水水水水水水水水水树树石石石石石石石石石石石石石石石石石石石石石石石石石石石石石石石石石石石石石石石石石石石石石石石石石石石石树树树树稂稂草草树树树树草草树树树树树飾飾飾飾道道道道飾飾飾飾树树树树树树树树树树树树树树树树树树树
石石石石石石石石石石石石石树树树树树树树树草草草草草草草草草草水水水水水水水水水水水水树树树石石石石石石石石石石石石石石石石石石石石石石石石石石石石石石石石石石石石石石石石石石石石石石石石石石石石树树树树稂稂草草树树树树草草树树树树树無门無無道道道道無無無無树树树树树树树树树树树树树树树树树树树
石石石石石石石石石石石石石石树树树树树树树草草草草草草草草草草水水水水水水水水水水水树树树树石石石石石石石石石石石石石石石石石石石石石石石石石石石石石石石石石石石石石石石石石石石石石石石水水水水石树树树树稂稂土土树树草草草草飾飾飾飾树土道道道道道道道無门無無树树树树树树树树树树树树树树树树树树树
石石石石石石石石石石石石石石树树树树树树树树草草草草草草草草草草水水水水水水水水水树树树树树石石石石石石石石石石石石石石石石石石石石石石石石石石石石石石石石石石石石石石石石石石石石石水水水石石石石树树树树稂稂土土树树草草草草無门無無树土土土道道道道道道道树树树树树树飾飾飾飾树树树树树树树树树树树
石石石石石石石石石石石石石石石树树树树树树树树草草草草草草草草草水水水水水水水水树树树树树石石石石石石石石石石石石石石石石石石石石石石石石石石石石石石石石石石石石石石石石石石石石水水水石石石石石石树树树树稂稂草草土土土土草草土土土树树树土土土土土道道道土树树水水树土無门無無树树树树树树树树树树树
石石石石石石石石石石石石石石石树树树树树树树树树树草草草草草草草草水水水水水树水水树树树树石石石石石石石石石石石石石石石石石石石石石石石石石石石石石石石石石石石石石石石石石石石水水石石石石石石石石树树树树稂稂草草土土土土草草土花土土树树树花土土土道道土树树土水水土土土土土土树树树树树树树树树树树
石石石石石石石石石石石石石石石石树树树树树树树树树树树草草草草草草水水水树树树树水树树树树石石石石石石石石石石石石石石石石石石石石石石石石石石石石石石石石石石石石石石石石石石水水石石石石石石石石石树树树树稂稂稂稂树树树树土土花土花土树树树树树树土道道树树树土水水土土土土土土树树树树树树树树树树树
石石石石石石石石石石石石石石石石石树树树树树树树树树树树草草草草草草树水树树树树水水树树石石石石石石石石石石石石石石石石石石石石石石石石石石石石石石石石石穴穴穴穴穴穴穴穴穴水水石石石石石石石石石石树树树树稂稂稂稂树树树树土土土花土树树树树树树树土道道树树土土水水土土树树树树树树树树树树树树树树树
石石石石石石石石石石石石石石石石石石树树树树树树树树树树草草草草草树树水树树树树树水水石石石石石石石石石石石石石石石石石石石石石石石石石石石入石石石石石穴穴飾飾飾飾穴穴水水水石石石石石石石石石石石树树树树树树稂稂树树树树树树树树树树树树树树树树土道道树树土土土土土土树树树树树树树树树树树树树树树
石石石石石石石石石石石石石石石石石石石石石树树树树树树树树草草草树树石水树树树石石石水水石石石石石石石石石石石石石石石石石石石石石石石石石石穴石石石穴穴穴穴無门無無水水水石石石石石石石石石石石石石树树树树树树稂稂树树树树树树树树树树树道道道道道道道道树树树草草草草草草树树树树树树树树树树树树树树
石石石石石石石石石石石石石石石石石石石石石石石树树树树树树草草草石石石水石石石石石石石水水石石石石石石石石石石石石石石石石石石石石石石石石石穴穴穴道道道道道道道水水水穴穴穴穴石石石石石石石石石石石树树树树树树树树树树树树树树树树树树树道道道道道道道道树树树树稂稂稂草土树树树树树树树树树树树树树树
石石石石石石石石石石石石石石石石石石石石石石石石石石树树树石入石石石石水石石石石石石石石水水水水水水石石石石石石石石石石石石石石石石石石石石穴穴穴穴穴穴穴穴水道水穴飾飾飾飾穴石石石石石石石石石石石树树树树树树树树树树树树树树树树树树树道道草草草草草树树树树稂稂稂稂草草树树树树树树树树树树树树树树
石石石石石石石石石石石石石石石石石石石石石石石石石石石石石石石石石石石水石石石石石石石石石石石石石水水水水石石石石石石石石石石石石石石石石石石石穴穴穴穴水水水道穴穴飾飾飾飾穴穴石石石石石石石石石石石石石石石石石石石石石石石石石石石树树無無無無無草草树树树树稂稂稂稂稂树树树树树树树树树树树树树树树
石石石石石石石石石石石石石石石石石石石石石石石石石石石石石石石石石石石水石石石石石石石石石石石石石石石石水水水石石石石石石石石石石石石石石石石石穴穴水水水穴穴道穴穴無無無無穴穴穴穴石石石石石石石石石石石石石石石石石石石石石石石石石树树道道草草草草草树树树树树稂稂稂稂树树树树树树树树树树树树树树树
石石石石石石石石石石石石石石石石石石石石石石石石石石石石石石石石石石水水石石石石石石石石石石石石石石石石石石水水水水石石石石石石石石石石石石石石水水水穴穴穴穴道穴穴無门無無穴穴穴穴穴石石石石石入石石石石石石石石石石石石石石石石石石石石道道草草草草草草树树树树树树草稂树树树树树树树树树树树树树树树
石石石石石石石石石石石石石石石石石石石石石石石石石石石石石石石石石石水石石石石石石石石石石石石石石石石石石石石石石水水水石石石石石石石石石石石水水穴穴穴穴道道道道道道道穴穴飾飾飾飾穴穴穴穴石石穴石石石石石石石石石石石石石石石石石石石石道道草草草草草土土树树树树树草草树树树树树树树树树树树树树树树
石石石石石石石石石石石石石石石石石石石石石石石石石石石石石石石石石水水石石石石石石石石石石石石石石石石石石石石石石石石水水水水石石石石石水水水水穴穴穴穴穴道飾飾飾飾穴道穴穴無门無無道道穴穴穴穴穴石石石石石石石石石石石石草草土土土土土土道道道道道道道土土树树树树树草草树树树树树树树树树树树树树树树
石石石石石石石石石石石石石石石石石石石石石石石石石石石石石石石石石水石石石石石石石石石石石石石石石石石石石石石石石石石石石石水水水水水水水石石石穴穴穴穴穴道飾飾飾飾穴道穴穴穴道道道道穴穴穴穴石石石石石石石石石石石石石石草草土土土土土土道道道道道道道土土树树树树树草草树树树树树树树树树树树树树树树
石石石石石石石石石石石石石石石石石石石石石石石石石石石石石石石石水水石石石石石石石石石石石石石石石石石石石石石石石石石石石石石石石石石石石石石石石穴穴穴穴道無無無無穴道道道道道穴穴穴穴石石石石石石石石石石石石石石石石石土土草草石石石石石石石石石道道土土树树树树树草稂树树树树树树树树树树树树树树树
石石石石石石石石石石石石石石石石石石石石石石石石石石石石石石石水水石石石石石石石石石石石石石石石石石石石石石石石石石石石石石石石石石石石石石石石石石穴穴穴道無门無無穴道穴穴穴穴穴石石石石石石石石石石石石石石石石石石石石土土草草石稂稂草草草草土土道道土土树树树树树稂稂稂树树树树树树树树树树树树树树