???????????????
???????????????
???????????????
???????????????
???????????????
???????????????
???????????????
?_________?????
?_________?????
?__??_____?????
?__??_____?????
?_______???????
?_______???????
?????^?????????
???????????????