树树树树树树树树树树树树树树树树树树树树树树树树树树树树树树树树树树树树树树树树树树树树树树树树树树树树树树树树树树树树树树树树树树树树树树树树树树树树树树树树树树树树树树树树树树树树树树树
树树树树树树树树树树树树树树树树树树树树树树树树树树树树树树树树树树树树树树树树树树树树树树树树树树树树树树树树树树树树树树树树树树树树树树树树树树树树树树树树树树树树树树树树树树树树树树树
树树树树树树树树树树树树树树树树树树树树树树树树树树树树树树树树树树树树树树树树树树树树树树树树树树树树树树树树树树树树树树树树树树树树树树树树树树树树树树树树树树树树树树树树树树树树树树树
树树树树树树树树树树树树树树树树树树树树树树树树树树树树树树树树树树树树树树树树树树树树树树树树树树树树树树树树树树树树树树树树树树树树树树树树树树树树树树树树树树树树树树树树树树树树树树树
树树树树树树树树树树树树树树树树树树树树树树树树树树树树树树树树树树树树树树树树树树树树树树树树树树树树树树树树树树树树树树树树树树树树树树树树树树树树树树树树树树树树树树树树树树树树树树树
树树树树树树树树树树树树树树树树树树树树树树树树树树树树树树树树树树树树树树树树树树树树树树树树树树树树树树树树树树树树树树树树树树树树树树树树树树树树树树树树树树树树树树树树树树树树树树树
树树树树树树树树树树树树树树树树树树树树树树树树树树树树树树树树树树树树树树树树树树树树树树树树树树树树树树树树树树树树树树树树树树树树树树树树树树树树树树树树树树树树树树树树树树树树树树树
树树树树树树树树树树树树树树树树树树树树树树树树树树树树树树树树树树树树树树树树树树树树树树树树树树树树树树树树树树树树树树树树树树树树树树树树树树树树树树树树树树树树树树树树树树树树树树树
树树树树树树树树树树树树树树树树树树树树树树树树树树树树树树树树树树树树树树树树树树树树树树树树树树树树树树树树树树树树树树树树树树树树树树树树树树树树树树树树树树树树树树树树树树树树树树树
树树树树树树树树树树树树树树树树树树树树树树树树树树树树树树树树树树树树树树树树树树树树树树树树树树树树树树树水水水水水树树树树树树树树树树树树树树树树树树树树树树树树树树树树树树树树树树树
树树树树树树树树树树树树树树树树树树树树树树树树树树树树树树树树树树树树树树树树树树树树树树树树树树树树树水水水水水水水水树树树树树树树树树树树树树树树树树树树树树树树树树树树树树树树树树树
树树树树树树树树树树树树树树树树树树树树树树树树树树树树树树树树树树树树树树树树树树树树树树树树树树树水水水水水水水水水水水水树树树树树树树树树树树树树树树树树树树树树树树树树树树树树树树树
树树树树树树树树树树树树树树树树树树树树树树树树树树树树树树树树树树树树树树树树树树树树树树树树树树水水水水水水水水水水水水水水水树树树树树树树树树树树树树树树树树树树树树树树树树树树树树树
树树树树树树树树树树树树树树树树树树树树树树树树树树树树树树树树树树树树树树树树树树树树树树树树树水水水水水水水水水水水水水水水水水树树树树树树树树树树树树树树树树树树树树树树树树树树树树树
树树树树树树树树树树树树树树树树树树树树树树树树树树树树树树树树树树树树树树树树树树树树树树树树树水水水水水水水水水水水水水水水水水水树树树树树树树树树树树树树树树树树树树树树树树树树树树树
树树树树树树树树树树树树树树树树树树树树树树树树树树树树树树树树树树树树树树树树树树树树树树树树树水水水水水水水水水水水水水水水水水水水树树树树树树树树树树树树树树树树树树树树树树树树树树树
树树树树树树树树树树树树树树树树树树树树树树树树树树树树树树树树树树树树树树树树树树树树树树树树树水水水水水水水水水水水水水水水水水水水树树树树树树树树树树树树树树树树树树树树树树树树树树树
树树树树树树树树树树树树树树树树树树树树树树树树树树树树树树树树树树树树树树树树树树树树树树树树树水水水水水水水水水水水水水水水水水水水水树树树树树树树树树树树树树树树树树树树树树树树树树树
树树树树树树树树树树树树树树树树树树树树树树树树树树树树树树树树树树树树树树树树树树树树树树树树树水水水水水水水水水水水水水水水水水水水水树树树树树树树树树树树树树树树树树树树树树树树树树树
树树树树树树树树树树树树树树树树树树树树树树树树树树树树树树树树树树树树树树树树树树树树树树树树树树水水水水水水水水水水水水水水水水水水水树树树树树树树树树树树树树树树树树树树树树树树树树树
树树树树树树树树树树树树树树树树树树树树树树树树树树树树树树树树树树树树树树树树树树树树树树树树树树水水水水水水水水水水水水水水水水水水水水树树树树树树树树树树树树树树树树树树树树树树树树树
树树树树树树树树树树树树树树树树树树树树树树树树树树树树树树树树树树树树水水树树树树树树树树树树树树水水水水水水水水水水水水水水水水水水水水树树树树树树树树树树树树树树树树树树树树树树树树树
树树树树树树树树树树树树树树树树树树树树树树树树树树树树树树树树树树水水水水水树树树树树树树树树树树水水水水水水水水水水水水水水水水水水水水树树树树树树树树树树树树树树树树树树树树树树树树树
树树树树树树树树树树树树树树树树树树树水水树树树树树树树树树树树树水水水水水水水树树树树树树树树树树树水水水水水水水水水水水水水水水水水水水水树树树树树树树树树树树树树树树树树树树树树树树树
树树树树树树树树树树树树树树树树树树水水水水水水水树树树树树树树水水水水水水水水水水树树树树树树树树树水水水水水水水水水水水水水水水水水水水水树树树树树树树树树树树树树树树树树树树树树树树树
树树树树树树树树树树树树树树树树树水水水水水水水水水水水水水树水水水水水水水水水水水水水树树树树树水水水水水水水水水水水水水水水水水水水水水水树树树树树树树树树树树树树树树树树树树树树树树树
树树树树树树树树树树树树树树树树树水水水水水水水水水水水水水水水水水水水水水水水水水水水水水水水水水水水水水水水水水水水水水水水水水水水水水水树树树树树树树树树树树树树树树树树树树树树树树树
树树树树树树树树树树树树树树树树水水水水水水水水水水水水水水水水水水水水水水水水水水水水水水水水水水水水水水水水水水水水水水水水水水水水水水水树树树树树树树树树树树树树树树树树树树树树树树树
树树树树树树树树树树树树树树树树水水水水水水水水水水水水水水水水水水水水水水水水水水水水水水水水水水水水水水水水水水水水水水水水水水水水水水水树树树树树树树树树树树树树树树树树树树树树树树树
树树树树树树树树树树树树树树树树水水水水水水水水水水水水水水水水水水水水水水水水水水水水水水水水水水水水水水水水水水水水水水水水水水水水水水水树树树树树树树树树树树树树树树树树树树树树树树树
树树树树树树树树树树树树树树树树水水水水水水水水水水水水水水水水水水水水水水水水水水水水水水水水水水水水水水水水水水水水水水水水水水水水水水水树树树树树树树树树树树树树树树树树树树树树树树树
树树树树树树树树树树树树树树树树树树水水水水水水水水水水水水水水水水水水水水水水水水水水水水水水水水水水水水水水水水水水水水水水水水水水水水水树树树树树树树树树树树树树树树树树树树树树树树树
树树树树树树树树树树树树树树树树树树树水水水水水水水水水水水水水水水水水水水水水水水水水水水水水水水水水水水水水水水水水水水水水水水水水水水水無树树树树树树树树树树树树树树树树树树树树树树树
树树树树树树树树树树树树树树树树树树树树水水水水水水水水水水水水水水水水水水水水水水水水水水水水水水水水水水水水水水水水水水水水水水水水水水水無树树树树树树树树树树树树树树树树树树树树树树树
树树树树树树树树树树树树树树树树树树树树水水水水水水水水水水水水水水水水水水水水水水水水水水水水水水水水水水水水水水水水水水水水水水水水水水無無树树树树树树树树树树树树树树树树树树树树树树树
树树树树树树树树树树树树树树树树树树树树树水水水水水水水水水水水水水水水水水水水水水水水水水水水水水水水水水水水水水水水水水水水水水水水水水無無树树树树树树树树树树树树树树树树树树树树树树树
树树树树树树树树树树树树树树树树树树树树树树树水水水水水水水水水水水水水水水水水水水水水水水水水水水水水水水水水水水水水水水水水水水水水水無無無树树树树树树树树树树树树树树树树树树树树树树树
树树树树树树树树树树树树树树树树树树树树树树树树水水水水水水水水水水水水水水水水水水水水水水水水水水水水水水水水水水水水水水水水水水水水水無無無树树树树树树树树树树树树树树树树树树树树树树树
树树树树树树树树树树树树树树树树树树树树树树树树树树树水水水水水水水水水水水水水水水水水水水水水水水水水水水水水水水水水水水水水水水水水無無無树树树树树树树树树树树树树树树树树树树树树树树树
树树树树树树树树树树树树树树树树树树树树树树树树树树树树树树树水水水水水水水水水水水水水水水水水水水水水水水水水水水水水水水水水水水水水無無無树树树树树树树树树树树树树树树树树树树树树树树树
树树树树树树树树树树树树树树树树树树树树树树树树树树树树树树树树树树树水水水水水水水水水水水水水水水水水水水水水水水水水水水水水水水水無無無無树树树树树树树树树树树树树树树树树树树树树树树树
树树树树树树树树树树树树树树树树树树树树树树树树树树树树树树树树树树树树树树水水水水水水水水水水水水水水水水水水水水水水水水水水水水水無無無無树树树树树树树树树树树树树树树树树树树树树树树树
树树树树树树树树树树树树树树树树树树树树树树树树树树树树树树树树树树树树树树树树水水水水水水水水水水水水水水水水水水水水水水水水水水水無無無無树树树树树树树树树树树树树树树树树树树树树树树树
树树树树树树树树树树树树树树树树树树树树树树树树树树树树树树树树树树树树树树树树树树树水水水水水水水水水水水水水水水水水水水水水水水水無無無無树树树树树树树树树树树树树树树树树树树树树树树树
树树树树树树树树树树树树树树树树树树树树树树树树树树树树树树树树树树树树树树树树树树树树树水水水水水水水水水水水水水水水水水水水水水水無無無树树树树树树树树树树树树树树树树树树树树树树树树树
树树树树树树树树树树树树树树树树树树树树树树树树树树树树树树树树树树树树树树树树树树树树树树水水水水水水水水水水水水水水水水水水水水水無無無树树树树树树树树树树树树树树树树树树树树树树树树树
树树树树树树树树树树树树树树树树树树树树树树树树树树树树树树树树树树树树树树树树树树树树树树树水水水水水水水水水水水水水水水水水水水水無無無無树树树树树树树树树树树树树树树树树树树树树树树树
树树树树树树树树树树树树树树树树树树树树树树树树树树树树树树树树树树树树树树树树树树树树树树树水水水水水水水水水水水水水水水水水水水水無無無無树树树树树树树树树树树树树树树树树树树树树树树树
树树树树树树树树树树树树树树树树树树树树树树树树树树树树树树树树树树树树树树树树树树树树树树树水水水水水水水水水水水水水水水水水水水水水無無無树树树树树树树树树树树树树树树树树树树树树树树树
树树树树树树树树树树树树树树树树树树树树树树树树树树树树树树树树树树树树树树树树树树树树树树树水水水水水水水水水水水水水水水水水水水水水無無無無树树树树树树树树树树树树树树树树树树树树树树树
树树树树树树树树树树树树树树树树树树树树树树树树树树树树树树树树树树树树树树树树树树树树树树水水水水水水水水水水水水水水水水水水水水水水無無無無树树树树树树树树树树树树树树树树树树树树树树树
树树树树树树树树树树树树树树树树树树树树树树树树树树树树树树树树树树树树树树树树树树树树树水水水水水水水水水水水水水水水水水水水水水水水水無無無土树树树树树树草草草草草草草树树树树树树树树树
树树树树树树树树树树树树树树树树树树树树树树树树树树树树树树树树树树树树树树树树树树树树水水水水水水水水水水水水水水水水水水水水水水水水水無無無土土土土土土树土土土土土土土树树树树树树树树树
树树树树树树树树树树树树树树树树树树树树树树树树树树树树树树树树树树树树树树树树树树树水水水水水水水水水水水水水水水水水水水水水水水水水水無無無土土土果土土树草草草草草草草树树树树树树树树树
树树树树树树树树树树树树树树树树树树树树树树树树树树树树树树树树树树树树树树树树树树水水水水水水水水水水水水水水水水水水水水水水水水水水水無無無土土土土土土树土土土土土土土树树树树树树树树树
树树树树树树树树树树树树树树树树树树树树树树树树树树树树树树树树树树树树树树树树树树水水水水水水水水水水水水水水水水水水水水水水水水水水水無無無土土土土土土树草草草草草草草树树树树树树树树树
树树树树树树树树树树树树树树树树树树树树树树树树树树树树树树树树树树树树树树树树树水水水水水水水水水水水水水水水水水水水水水水水水水水水飾飾飾飾飾飾飾飾土土土土土土土土土土树树树树树树树树树
树树树树树树树树树树树树树树树树树树树树树树树树树树树树树树树树树树树树树树树树树水水水水水水水水水水水水水水水水水水水水水水水水水水水無门無無门無無無土土树草草草草草草草树树树树树树树树树
树树树树树树树树树树树树树树树树树树树树树树树树树树树树树树树树树树树树树树树树水水水水水水水水水水水水水水水水水水水水水水水水水水水水無無树土土土土土土土树树树树树树树树树树树树树树树树树
树树树树树树树树树树树树树树树树树树树树树树树树树树树树树树树树树树树树树树树树水水水水水水水水水水水水水水水水水水水水水水水水水水水無無無树土土土土土土土树树树树树树树树树树树树树树树树树
树树树树树树树树树树树树树树树树树树树树树树树树树树树树树树树树树树树树树树树水水水水水水水水水水水水水水水水水水水水水水水水水水水水無無無树土土树树树树树树树树树树树树树树树树树树树树树树
树树树树树树树树树树树树树树树树树树树树树树树树树树树树树树树树树树树树树树树水水水水水水水水水水水水水水水水水水水水水水水水水水水無無無無树土土树树树树树树树树树树树树树树树树树树树树树树
树树树树树树树树树树树树树树树树树树树树树树树树树树树树树树树树树树树树树树树水水水水水水水水水水水水水水水水水水水水水水水水水水水無無無树树土土树树树树树树树树树树树树树树树树树树树树树树
树树树树树树树树树树树树树树树树树树树树树树树树树树树树树树树树树树树树树树水水水水水水水水水水水水水水水水水水水水水水水水水水水無無無無树树土土树树树树树树树树树树树树树树树树树树树树树树
树树树树树树树树树树树树树树树树树树树树树树树树树树树树树树树树树树树树树树水水水水水水水水水水水水水水水水水水水水水水水水水水無無無無树树树土土树树树树树树树树树树树树树树树树树树树树树树
树树树树树树树树树树树树树树树树树树树树树树树树树树树树树树树树树树树树树树水水水水水水水水水水水水水水水水水水水水水水水水水無無無树树树树树土土树树树树树树树树树树树树树树树树树树树树树树
树树树树树树树树树树树树树树树树树树树树树树树树树树树树树树树树树树树树树树水水水水水飾水水水水水水水水水水水水水水水水水水水無飾飾飾飾树树树土土树树树树树树树树树树树树树树树树树树树树道道
树树树树树树树树树树树树树树树树树树树树树树树树树树树树树树树树树草草草草草水水道道飾飾飾道道水水水水水水水水水水水水水水無無無無门無無树树树草草树树树树树树树树树树树树树树树树道道道道道道
树树树树树树树树树树树树树树树树树树树树树树树树树树树树树树树树草草草草草水水水道飾飾飾飾飾道水水水水水水水水水水水水水無無無無無無树树树草草草草树树树树树树树树树树树树树树树道道道道道道道
飾树树树树树树树树树树树树树树树树树树树树树树树树树树草草草草草草草草草草水水水道無無门無無道水水水水水水水水水水水水無無無無無無树树树树草草草草树树树树树树树树树树树树树道道道道道道道道道
飾树树树树树树树树树树树树树树树树树树树树树树树树树树草飾飾飾飾草草草水水水水水道道道道道道道水水水水水水水水無無無無無無無無树树树树树树草草树树树树树树树树树树树树树树道道道道道道道道道道
無树树树树树树树树树树树树树树树树树树树树树树树树树树草無门無無草草草水水水水水水水水道道水水水水水水水無無無無無無無無無無树树树树树树树草草树树树树树树树树树树树树树树道道道道道道道道道道
無飾飾飾飾树树树树树树树树树树树树树树树树树树树树树树草草草草草水水水水水水水水水水水道道水水水水水树树树树無無無道道無無树树树树树树树树草草树树树树树树树树树树树树树道道道道道道道道道道道
土無门無無树树树树树树树树树树树树树树树树树树树树树树树树草草草水水水水水水水水水水水道道水水水树树树树树树树树土道道土树树树树树树树树稂稂稂稂树树树树树树树树树树树树道道道道道道道道道道道
土土道土土树树树树树树树树树树树树树树树树树草土土土草土土草草草草草草草草草草草草树树道道树水水树树树树树树树树土道道土树树树树树树稂稂稂稂稂稂稂树树树树树树树树树树树道道道道道道道道道道道
道道道道道土树树树树树树树树树树树飾飾飾飾树土土草土土土草草草草草草草草草草草草草树树道道树水水树树树树树树树树土道道土树树树树树稂稂稂稂稂稂稂稂稂稂树树树树树树树树道道道道道道道道道道道道
土土土土道土土土土树树树树树树树树無门無無树土土树树树树树草草树树土土草草草草土土树树道道水水水树树树树树树树树土道道草树树树树稂树稂稂稂树稂稂稂稂稂稂稂草草土土土土土道道道道道道道道道道道
水水水土道土土土土树树树树树树树树土土土土树土土树树树树树草草树树土土草草草草土土土土道道水水水土土土土土土土土土道道草草草稂稂稂稂树稂稂稂稂稂稂稂稂稂稂稂草草土土土土道道道道道道道道道道道
水水水土道道道道道道道道道道道土土土土土土土土土草草草草草草草道道道道树树树树道道道道道道道水道道道道道道道道道道道道草草稂稂树稂稂稂稂草道道道草草草稂稂稂草草草土土土道道道道道道道道道道道
水水水土道道道道道道道道道道道土土土土土土土土土草草草草草草草道道道道树树树树道道道道道道水道道道道道道道道道道道道道草草稂稂稂稂稂稂草草道道草草草道稂稂稂稂草草草土土道道道道道道道道道道道
水水水土道土土树树树树树树树树树树树树树树树树树土土树树树草草树树树树树树树树土土土土土土水水土土土土土土土土土土道道道道草草草草草道道道道道稂稂道道道道道道道道道道道道道道道道道道道道道道
土土土土道土树树树树树树树树树树树树树树树树树树土土树树树草草树树树树树树树树土土树树树树水水树树树树树树树树树土道道道道草草草草道道道道道道稂稂道道道道道道道道道道道道道道道道道道道道道道
道道道道道树树树树树树树树树树树树树树树树树树树草草草草草草草树树飾飾飾飾树树草草树树树水水水树树树树树树树树树树树草草草稂稂稂稂草草草草草稂稂稂稂稂稂树树树树树树树道道道道道道道道道道道道
飾飾飾飾树树树树树树树树树树树树树树树树树树树树草草草草草草草树树無门無無树树草草树树树水水水树树树树树树树树树树树草草稂稂稂稂稂稂草草草草稂树稂稂稂稂树树树树树树树道道道道道道道道道道道道
飾飾飾飾树树树树树树树树树树树树树树树树树树树树树树土土树树树树树土土树树树树草草树树树水水树树树树树树树树树树树树树树稂稂稂稂稂稂稂稂稂稂树树树稂稂稂树树树树树树树道道道道道道道道道道道道
無無無無树树树树树树树树树树树树树树树树树树树树树树土土树树树树树土土树树树树草草树树树水树树树树树树树树树树树树树树树树稂稂稂稂稂稂稂稂稂树树树树稂稂树树树树树树树道道道道道道道道道道道道
無门無無树树树树树树树树树树树树树树树树树树树树树树土土土土土土土土土草草草草草草树树树水树树树树树树树树树树树树树树树树树树稂稂稂稂稂树树树树树树树树树树树树树树树道道道道道道道道道道道道
道道树树树树树树飾飾飾飾树树树树树树树树树树树树树树土土土土土土土土土草草草草草草树树树水树树树树树树树树树树树树树树树树树树树树草草树树树树树树树树树树树树树树树树道道道道道道道道道道道道
道土树树水水树土無门無無树树树树树树树树树树树树树树树树树树树树树树树树树树树树树树树树水树树树树树树树树树树树树树树树树树树树树草草树树树树树树树树树树树树树树树树树道道道道道道道道道道道
土树树土水水土土土土土土树树树树树树树树树树树树树树树树树树树树树树树树树树树树树树树水水树树树树树树树树树树树树树树树树树树树树草草树树树树树树树树树树树树树树树树树树道道道道道道道道道道
树树树土水水土土土土土土树树树树树树树树树树树树树树树树树树树树树树树树树树树树树树树水树树树树树树树树树树树树树树树树树树树树树草草树树树树树树树树树树树树树树树树树树道道道道道道道道道道
树树土土水水土土树树树树树树树树树树树树树树树树树树树树树树树树树树树树树树树树树树水水树树树树树树树树树树树树树树树树树树树树树土土树树飾飾飾飾土土土树树树树树树树树树树道道道道道道道道道
树树土土土土土土树树树树树树树树树树树树树树树树树树树树树树树树树树树树树树树树树树水树树树树树树树树树树树树树树树树树树树树树树土土树树無门無無土果土树树树树树树树树树树树树道道道道道道道
树树树草草草草草草树树树树树树树树树树树树树树树树树树树树树树树树树树树树树树树树树水树树树树树树树树树树树树树树树树树树树树树树土土土土土土土土土土土树树树树树树树树树树树树树道道水水水水
树树树树稂稂稂草土树树树树树树树树树树树树树树树树树树树树树树树树树树树树树树树树树水树树树树树树树树树树树树树树树树树树树树树树土土土土土土土土土土土树树树树树树树树树树树树树水水水道道道
树树树稂稂稂稂草草树树树树树树树树树树树树树树树树树树树树树树树树树树树树树树树树树树树树树树树树树树树树树树树树树树树树树树树树树树树树树树树树树树树树树树树树树树树树树树水水树道道道道道
树树树稂稂稂稂稂树树树树树树树树树树树树树树树树树树树树树树树树树树树树树树树树树树树树树树树树树树树树树树树树树树树树树树树树树树树树树树树树树树树树树树树树树树树树树树水树树树道道道道道