???????????????
???????????????
???????????????
???????????????
???????????????
???????????????
???????????????
???????????????
????____?__????
????____???????
????_______????
????_______????
????_______????
???????^???????
???????????????