树树树树树树树树树树树树树树树树树树树树树树树树树树树树树树树树树树树树树树树树树树树树树树树树树树树树树树树树树树树树树树树树树树树树树树树树树树树树树树树树树树树树树树树树树树树树树树树
树树树树树树树树树树树树树树树树树树树树树树树树树树树树树树树树树树树树树树树树树树树树树树树树树树树树树树树树树树树树树树树树树树树树树树树树树树树树树树树树树树树树树树树树树树树树树树树
树树树树树树树树树树树树树树树树树树树树树树树树树树树树树树树树树树树树树树树树树树树树树树树树树树树树树树树树树树树树树树树树树树树树树树树树树树树树树树树树树树树树树树树树树树树树树树树
树树树树树树树树树树树树树树树树树树树树树树树树树树树树树树树树树树树树树树树树树树树树树树树树树树树树树树树树树树树树树树树树树树树树树树树树树树树树树树树树树树树树树树树树树树树树树树树
树树树树树树树树树树树树树树树树树树树树树树树树树树树树树树树树树树树树树树树树树树树树树树树树树树树树树树树树树树树树树树树树树树树树树树树树树树树树树树树树树树树树树树树树树树树树树树树
树树树树树树树树树树树树树树树树树树树树树树树树树树树树树树树树树树树树树树树树树树树树树树树树树树树树树树树树树树树树树树树树树树树树树树树树树树树树树树树树树树树树树树树树树树树树树树树
树树树树树树树树树树树树树树树树树树树树树树树树树树树树树树树树树树树树树树树树树树树树树树树树树树树树树树树树树树树树树树树树树树树树树树树树树树树树树树树树树树树树树树树树树树树树树树树
树树树树树树树树树树树树树树树树树树树树树树树树树树树树树树树树树树树树树树树树树树树树树树树树树树树树树树树树树树树树树树树树树树树树树树树树树树树树树树树树树树树树树树树树树树树树树树树
树树树树树树树树树树树树树树树树树树树树树树树树树树树树树树树树树树树树树树树树树树树树树树树树树树树树树树树树树树树树树树树树树树树树树树树树树树树树树树树树树树树树树树树树树树树树树树树
树树树树树树树树树树树树树树树树树树树树树树树树树树树树树树树树树树树树树树树树树树树树树树树树树树树树树树树水水水水水树树树树树树树树树树树树树树树树树树树树树树树树树树树树树树树树树树树
树树树树树树树树树树树树树树树树树树树树树树树树树树树树树树树树树树树树树树树树树树树树树树树树树树树树树水水水水水水水水树树树树树树树树树树树树树树树树树树树树树树树树树树树树树树树树树树
树树树树树树树树树树树树树树树树树树树树树树树树树树树树树树树树树树树树树树树树树树树树树树树树树树树水水水水水水水水水水水水树树树树树树树树树树树树树树树树树树树树树树树树树树树树树树树树
树树树树树树树树树树树树树树树树树树树树树树树树树树树树树树树树树树树树树树树树树树树树树树树树树树水水水水水水水水水水水水水水水树树树树树树树树树树树树树树树树树树树树树树树树树树树树树树
树树树树树树树树树树树树树树树树树树树树树树树树树树树树树树树树树树树树树树树树树树树树树树树树树水水水水水水水水水水水水水水水水水树树树树树树树树树树树树树树树树树树树树树树树树树树树树树
树树树树树树树树树树树树树树树树树树树树树树树树树树树树树树树树树树树树树树树树树树树树树树树树树水水水水水水水水水水水水水水水水水水树树树树树树树树树树树树树树树树树树树树树树树树树树树树
树树树树树树树树树树树树树树树树树树树树树树树树树树树树树树树树树树树树树树树树树树树树树树树树树水水水水水水水水水水水水水水水水水水水树树树树树树树树树树树树树树树树树树树树树树树树树树树
树树树树树树树树树树树树树树树树树树树树树树树树树树树树树树树树树树树树树树树树树树树树树树树树树水水水水水水水水水水水水水水水水水水水树树树树树树树树树树树树树树树树树树树树树树树树树树树
树树树树树树树树树树树树树树树树树树树树树树树树树树树树树树树树树树树树树树树树树树树树树树树树树水水水水水水水水水水水水水水水水水水水水树树树树树树树树树树树树树树树树树树树树树树树树树树
树树树树树树树树树树树树树树树树树树树树树树树树树树树树树树树树树树树树树树树树树树树树树树树树树水水水水水水水水水水水水水水水水水水水水树树树树树树树树树树树树树树树树树树树树树树树树树树
树树树树树树树树树树树树树树树树树树树树树树树树树树树树树树树树树树树树树树树树树树树树树树树树树树水水水水水水水水水水水水水水水水水水水树树树树树树树树树树树树树树树树树树树树树树树树树树
树树树树树树树树树树树树树树树树树树树树树树树树树树树树树树树树树树树树树树树树树树树树树树树树树树水水水水水水水水水水水水水水水水水水水水树树树树树树树树树树树树树树树树树树树树树树树树树
树树树树树树树树树树树树树树树树树树树树树树树树树树树树树树树树树树树树水水树树树树树树树树树树树树水水水水水水水水水水水水水水水水水水水水树树树树树树树树树树树树树树树树树树树树树树树树树
树树树树树树树树树树树树树树树树树树树树树树树树树树树树树树树树树树水水水水水树树树树树树树树树树树水水水水水水水水水水水水水水水水水水水水树树树树树树树树树树树树树树树树树树树树树树树树树
树树树树树树树树树树树树树树树树树树树水水树树树树树树树树树树树树水水水水水水水树树树树树树树树树树树水水水水水水水水水水水水水水水水水水水水树树树树树树树树树树树树树树树树树树树树树树树树
树树树树树树树树树树树树树树树树树树水水水水水水水树树树树树树树水水水水水水水水水水树树树树树树树树树水水水水水水水水水水水水水水水水水水水水树树树树树树树树树树树树树树树树树树树树树树树树
树树树树树树树树树树树树树树树树树水水水水水水水水水水水水水树水水水水水水水水水水水水水树树树树树水水水水水水水水水水水水水水水水水水水水水水树树树树树树树树树树树树树树树树树树树树树树树树
树树树树树树树树树树树树树树树树树水水水水水水水水水水水水水水水水水水水水水水水水水水水水水水水水水水水水水水水水水水水水水水水水水水水水水水树树树树树树树树树树树树树树树树树树树树树树树树
树树树树树树树树树树树树树树树树水水水水水水水水水水水水水水水水水水水水水水水水水水水水水水水水水水水水水水水水水水水水水水水水水水水水水水水树树树树树树树树树树树树树树树树树树树树树树树树
树树树树树树树树树树树树树树树树水水水水水水水水水水水水水水水水水水水水水水水水水水水水水水水水水水水水水水水水水水水水水水水水水水水水水水水树树树树树树树树树树树树树树树树树树树树树树树树
树树树树树树树树树树树树树树树树水水水水水水水水水水水水水水水水水水水水水水水水水水水水水水水水水水水水水水水水水水水水水水水水水水水水水水水树树树树树树树树树树树树树树树树树树树树树树树树
树树树树树树树树树树树树树树树树水水水水水水水水水水水水水水水水水水水水水水水水水水水水水水水水水水水水水水水水水水水水水水水水水水水水水水水树树树树树树树树树树树树树树树树树树树树树树树树
树树树树树树树树树树树树树树树树树树水水水水水水水水水水水水水水水水水水水水水水水水水水水水水水水水水水水水水水水水水水水水水水水水水水水水水树树树树树树树树树树树树树树树树树树树树树树树树
树树树树树树树树树树树树树树树树树树树水水水水水水水水水水水水水水水水水水水水水水水水水水水水水水水水水水水水水水水水水水水水水水水水水水水水树树树树树树树树树树树树树树树树树树树树树树树树
树树树树树树树树树树树树树树树树树树树树水水水水水水水水水水水水水水水水水水水水水水水水水水水水水水水水水水水水水水水水水水水水水水水水水水水树树树树树树树树树树树树树树树树树树树树树树树树
树树树树树树树树树树树树树树树树树树树树水水水水水水水水水水水水水水水水水水水水水水水水水水水水水水水水水水水水水水水水水水水水水水水水水水树树树树树树树树树树树树树树树树树树树树树树树树树
树树树树树树树树树树树树树树树树树树树树树水水水水水水水水水水水水水水水水水水水水水水水水水水水水水水水水水水水水水水水水水水水水水水水水水树树树树树树树树树树树树树树树树树树树树树树树树树
树树树树树树树树树树树树树树树树树树树树树树树水水水水水水水水水水水水水水水水水水水水水水水水水水水水水水水水水水水水水水水水水水水水水水树树树树树树树树树树树树树树树树树树树树树树树树树树
树树树树树树树树树树树树树树树树树树树树树树树树水水水水水水水水水水水水水水水水水水水水水水水水水水水水水水水水水水水水水水水水水水水水水树树树树树树树树树树树树树树树树树树树树树树树树树树
树树树树树树树树树树树树树树树树树树树树树树树树树树树水水水水水水水水水水水水水水水水水水水水水水水水水水水水水水水水水水水水水水水水水树树树树树树树树树树树树树树树树树树树树树树树树树树树
树树树树树树树树树树树树树树树树树树树树树树树树树树树树树树树水水水水水水水水水水水水水水水水水水水水水水水水水水水水水水水水水水水水水树树树树树树树树树树树树树树树树树树树树树树树树树树树
树树树树树树树树树树树树树树树树树树树树树树树树树树树树树树树树树树树水水水水水水水水水水水水水水水水水水水水水水水水水水水水水水水水树树树树树树树树树树树树树树树树树树树树树树树树树树树树
树树树树树树树树树树树树树树树树树树树树树树树树树树树树树树树树树树树树树树水水水水水水水水水水水水水水水水水水水水水水水水水水水水水树树树树树树树树树树树树树树树树树树树树树树树树树树树树
树树树树树树树树树树树树树树树树树树树树树树树树树树树树树树树树树树树树树树树树水水水水水水水水水水水水水水水水水水水水水水水水水水水树树树树树树树树树树树树树树树树树树树树树树树树树树树树
树树树树树树树树树树树树树树树树树树树树树树树树树树树树树树树树树树树树树树树树树树树水水水水水水水水水水水水水水水水水水水水水水水水树树树树树树树树树树树树树树树树树树树树树树树树树树树树
树树树树树树树树树树树树树树树树树树树树树树树树树树树树树树树树树树树树树树树树树树树树树水水水水水水水水水水水水水水水水水水水水水水树树树树树树树树树树树树树树树树树树树树树树树树树树树树
树树树树树树树树树树树树树树树树树树树树树树树树树树树树树树树树树树树树树树树树树树树树树树水水水水水水水水水水水水水水水水水水水水水树树树树树树树树树树树树树树树树树树树树树树树树树树树树
树树树树树树树树树树树树树树树树树树树树树树树树树树树树树树树树树树树树树树树树树树树树树树树水水水水水水水水水水水水水水水水水水水水树树树树树树树树树树树树树树树树树树树树树树树树树树树树
树树树树树树树树树树树树树树树树树树树树树树树树树树树树树树树树树树树树树树树树树树树树树树树水水水水水水水水水水水水水水水水水水水水树树树树树树树树树树树树树树树树树树树树树树树树树树树树
树树树树树树树树树树树树树树树树树树树树树树树树树树树树树树树树树树树树树树树树树树树树树树树水水水水水水水水水水水水水水水水水水水水水树树树树树树树树树树树树树树树树树树树树树树树树树树树
树树树树树树树树树树树树树树树树树树树树树树树树树树树树树树树树树树树树树树树树树树树树树树树水水水水水水水水水水水水水水水水水水水水水树树树树树树树树树树树树树树树树树树树树树树树树树树树
树树树树树树树树树树树树树树树树树树树树树树树树树树树树树树树树树树树树树树树树树树树树树树水水水水水水水水水水水水水水水水水水水水水水树树树树树树树树树树树树树树树树树树树树树树树树树树树
树树树树树树树树树树树树树树树树树树树树树树树树树树树树树树树树树树树树树树树树树树树树树水水水水水水水水水水水水水水水水水水水水水水水水树树树树树树树树树树树树树树树树树树树树树树树树树树
树树树树树树树树树树树树树树树树树树树树树树树树树树树树树树树树树树树树树树树树树树树树水水水水水水水水水水水水水水水水水水水水水水水水水树树树树树树树树树树树树树树树树树树树树树树树树树树
树树树树树树树树树树树树树树树树树树树树树树树树树树树树树树树树树树树树树树树树树树树水水水水水水水水水水水水水水水水水水水水水水水水水水树树树树树树树树树树树树树树树树树树树树树树树树树树
树树树树树树树树树树树树树树树树树树树树树树树树树树树树树树树树树树树树树树树树树树水水水水水水水水水水水水水水水水水水水水水水水水水水水树树树树树树树树树树树树树树树树树树树树树树树树树树
树树树树树树树树树树树树树树树树树树树树树树树树树树树树树树树树树树树树树树树树树树水水水水水水水水水水水水水水水水水水水水水水水水水水水树树树树树树树树树树树树树树树树树树树树树树树树树树
树树树树树树树树树树树树树树树树树树树树树树树树树树树树树树树树树树树树树树树树树水水水水水水水水水水水水水水水水水水水水水水水水水水水树树树树树树树树树树树树树树树树树树树树树树树树树树树
树树树树树树树树树树树树树树树树树树树树树树树树树树树树树树树树树树树树树树树树树水水水水水水水水水水水水水水水水水水水水水水水水水水水树树树树树树树树树树树树树树树树树树树树树树树树树树树
树树树树树树树树树树树树树树树树树树树树树树树树树树树树树树树树树树树树树树树树树水水水水水水水水水水水水水水水水水水水水水水水水水水水树树树树树树树树树树树树树树树树树树树树树树树树树树树
树树树树树树树树树树树树树树树树树树树树树树树树树树树树树树树树树树树树树树树树水水水水水水水水水水水水水水水水水水水水水水水水水水水树树树树树树树树树树树树树树树树树树树树树树树树树树树树
树树树树树树树树树树树树树树树树树树树树树树树树树树树树树树树树树树树树树树树树水水水水水水水水水水水水水水水水水水水水水水水水水水水树树树树树树树树树树树树树树树树树树树树树树树树树树树树
树树树树树树树树树树树树树树树树树树树树树树树树树树树树树树树树树树树树树树树树水水水水水水水水水水水水水水水水水水水水水水水水水水树树树树树树树树树树树树树树树树树树树树树树树树树树树树树
树树树树树树树树树树树树树树树树树树树树树树树树树树树树树树树树树树树树树树树树水水水水水水水水水水水水水水水水水水水水水水水水水水树树树树树树树树树树树树树树树树树树树树树树树树树树树树树
树树树树树树树树树树树树树树树树树树树树树树树树树树树树树树树树树树树树树树树树水水水水水水水水水水水水水水水水水水水水水水水水水树树树树树树树树树树树树树树树树树树树树树树树树树树树树树树
树树树树树树树树树树树树树树树树树树树树树树树树树树树树树树树树树树树树树树树树水水水水水水水水水水水水水水水水水水水水水水水水树树树树树树树树树树树树树树树树树树树树树树树树树树树树树树树
树树树树树树树树树树树树树树树树树树树树树树树树树树树树树树树树树树树树树树树树水水水水水水水水水水水水水水水水水水水水水水水树树树树树树树树树树树树树树树树树树树树树树树树树树树树树树树树
树树树树树树树树树树树树树树树树树树树树树树树树树树树树树树树树树树树树树树树水水道道道道道道水水水水水水水水水水水水水水水水树树树树树树树树树树树树树树树树树树树树树树树树树树树树树树道道
树树树树树树树树树树树树树树树树树树树树树树树树树树树树树树树树树草草草草草草水水道飾飾飾飾道水水水水水水水水水水水水水水树树树树树树树树树树树树树树树树树树树树树树树树树树树树道道道道道道
树树树树树树树树树树树树树树树树树树树树树树树树树树树树树树树树草草草草草水水水水道飾飾飾飾道水水水水水水水水水水水水水树树树树树树树树树树树树树树树树树树树树树树树树树树树树道道道道道道道
飾树树树树树树树树树树树树树树树树树树树树树树树树树树草草草草草草草草草草水水水水道無门無無道水水水水水水水水水水水树树树树树树树树树树树树树树树树树树树树树树树树树树树树道道道道道道道道道
飾树树树树树树树树树树树树树树树树树树树树树树树树树树草飾飾飾飾草草草水水水水水水道道道道道道水水水水水水水水树树树树树树树树树树树树树树树树树树树树树树树树树树树树树树道道道道道道道道道道
無树树树树树树树树树树树树树树树树树树树树树树树树树树草無门無無草草草水水水水水水水水道道水水水水水水水树树树树树树树树树树树树树树树树树树树树树树树树树树树树树树树树树道道道道道道道道道道
無飾飾飾飾树树树树树树树树树树树树树树树树树树树树树树草草草草草水水水水水水水水水水水道道水水水树树树树树树树树树树树树树树树树树树树树树树树树树树树树树树树树树树树树道道道道道道道道道道道
道無门無無树树树树树树树树树树树树树树树树树树树树树树树树草草草水水水水水水水水水树树土土树水水树树树树树树树树树树树树树树树树树树树树树树树树树树树树树树树树树树树树道道道道道道道道道道道
道道道道道树树树树树树树树树树树树树树树树树草土土土草土土草草草草草草草草草草草草树树土土树水水树树树树树树树树树树树树树树树树树树树树树树树树树树树树树树树树树树树树道道道道道道道道道道道
道道道道道树树树树树树树树树树树树飾飾飾飾树土土草土土土草草草草草草草草草草草草草树树土土树水水树树树树树树树树树树树树树树树树树树树树树树树树树树树树树树树树树树树道道道道道道道道道道道道
道道道道道土土土土树树树树树树树树無门無無树土土树树树树树草草树树土土草草草草土土树树土土水水水树树树树树树树树树树树树树树树树树树树树树树树树树树树树树树树树树树树道道道道道道道道道道道道
道道道道道土土土土树树树树树树树树土土土土树土土树树树树树草草树树土土草草草草土土树树土土水水水树树树树树树树树树树树树树树树树树树树树树树树树树树树树树树树树树树树道道道道道道道道道道道道
土土道道道道道道道道道道道道道土土土土土土土土土草草草草草草草道道道道树树树树道道道道道道道水道道道道道道道树树树道道道道道道道道道道道道道道道道道道道道道道道道道道道道道道道道道道道道道道
花花道道道道道道道道道道道道道土土土土土土土土土草草草草草草草道道道道树树树树道道道道道道水道道道道道道道道树树树道道道道道道道道道道道道道道道道道道道道道道道道道道道道道道道道道道道道道道
道道道道树树树树树树树树树树树树树树树树树树树树土土树树树草草树树树树树树树树土土树树树树水水树树树树树树树树树树树树树树树树树树树树树树树树树树树树树树树树树树树树道道道道道道道道道道道道
道道道道树树树树树树树树树树树树树树树树树树树树土土树树树草草树树树树树树树树土土树树树树水水树树树树树树树树树树树树树树树树树树树树树树树树树树树树树树树树树树树树道道道道道道道道道道道道
道道道道树树树树树树树树树树树树树树树树树树树树草草草草草草草树树飾飾飾飾树树草草树树树水水水树树树树树树树树树树树树树树树树树树树树树树树树树树树树树树树树树树树树道道道道道道道道道道道道
飾飾飾飾树树树树树树树树树树树树树树树树树树树树草草草草草草草树树無门無無树树草草树树树水水水树树树树树树树树树树树树树树树树树树树树树树树树树树树树树树树树树树树树道道道道道道道道道道道道
飾飾飾飾树树树树树树树树树树树树树树树树树树树树树树土土树树树树树土土树树树树草草树树树水水树树树树树树树树树树树树树树树树树树树树树树树树树树树树树树树树树树树树树道道道道道道道道道道道道
無無無無树树树树树树树树树树树树树树树树树树树树树树土土树树树树树土土树树树树草草树树树水树树树树树树树树树树树树树树树树树树树树树树树树树树树树树树树树树树树树树树道道道道道道道道道道道道
無门無無树树树树树树树树树树树树树树树树树树树树树树土土土土土土土土土草草草草草草树树树水树树树树树树树树树树树树树树树树树树树树树树树树树树树树树树树树树树树树树树道道道道道道道道道道道道
道道树树树树树树飾飾飾飾树树树树树树树树树树树树树树土土土土土土土土土草草草草草草树树树水树树树树树树树树树树树树树树树树树树树树树树树树树树树树树树树树树树树树树树道道道道道道道道道道道道
道道树树水水树土無门無無树树树树树树树树树树树树树树树树树树树树树树树树树树树树树树树树水树树树树树树树树树树树树树树树树树树树树树树树树树树树树树树树树树树树树树树树道道道道道道道道道道道
树树树土水水土土土土土土树树树树树树树树树树树树树树树树树树树树树树树树树树树树树树树水水树树树树树树树树树树树树树树树树树树树树树树树树树树树树树树树树树树树树树树树树道道道道道道道道道道
树树树土水水土土土土土土树树树树树树树树树树树树树树树树树树树树树树树树树树树树树树树水树树树树树树树树树树树树树树树树树树树树树树树树树树树树树树树树树树树树树树树树树道道道道道道道道道道
树树土土水水土土树树树树树树树树树树树树树树树树树树树树树树树树树树树树树树树树树树水水树树树树树树树树树树树树树树树树树树树树树树树树树树树树树树树树树树树树树树树树树树道道道道道道道道道
树树土土土土土土树树树树树树树树树树树树树树树树树树树树树树树树树树树树树树树树树树水树树树树树树树树树树树树树树树树树树树树树树树树树树树树树树树树树树树树树树树树树树树树树道道道道道道道
树树树草草草草草草树树树树树树树树树树树树树树树树树树树树树树树树树树树树树树树树树水树树树树树树树树树树树树树树树树树树树树树树树树树树树树树树树树树树树树树树树树树树树树树树道道道道道道
树树树树稂稂稂草土树树树树树树树树树树树树树树树树树树树树树树树树树树树树树树树树树水树树树树树树树树树树树树树树树树树树树树树树树树树树树树树树树树树树树树树树树树树树树树树树树树道道道道
树树树稂稂稂稂草草树树树树树树树树树树树树树树树树树树树树树树树树树树树树树树树树树树树树树树树树树树树树树树树树树树树树树树树树树树树树树树树树树树树树树树树树树树树树树树树树树树树道道道
树树树稂稂稂稂稂树树树树树树树树树树树树树树树树树树树树树树树树树树树树树树树树树树树树树树树树树树树树树树树树树树树树树树树树树树树树树树树树树树树树树树树树树树树树树树树树树树树道道道道