道道花土花土花無土土土土土土石石石石石石石石石石石石石石石石石石石石石石石石石石石石石石石石石石石石石石石石石石石石石石石石石石石石石石石石石石石石石石石石石石石石石石水石石石石石石石石石石石石石石石石石石石石石石石石石石石石石石石石石石石石石石石石石石石石石石石石石石石石石石石石石石石石石土土
道道土飾飾飾飾飾土石石石石石石石石石石石石石石石石石石石石石石石石石石石石石石石石石石石石石石石石石石石石石石石石石石石石石石石石石石石石石石石石石石石石石石石石石石石石水石石石石石石石石石石石石石石石石石石石石石石石石石石石石石石石石石石石石石石石石石石石石石石石石石石石石石石石石石石石石土土
道道花飾飾飾飾飾土石石石石石石石石石石石石石石石石石石石石石石石石石石石石石石石石石石石石石石石石石石石石石石石石石石石石石石石石石石石石石石石石石石石石石石石石石石石石水水石石石石石石石石石石石石石石石石石石石石石石石石石石石石石石石石石石石石石石石石石石石石石石石石石石石石石石石石石石石土土
道道土飾飾飾飾飾门石石石石石石石石石石石石石石石石石石石石石石石石石石石石石石石石石石石石石石石石石石石石石石石石石石石石石石石石石石石石石石石石石石石石石石石石石石石石石石水水水石石石石石石石石石石石石石石石石石石石石石石石石石石石石石石石石石石石石石石石石石石石石石石石石石石石石石石石石石石
道道花無無门無無無石石石石石石石石石石石石石石石石石石石石石石石石石石石石石石石石石石石石石石石石石石石石石石石石石石石石石石石石石石石石石石石石石石石石石石石石石石石石石石石石石水水石石石石石石石石石石石石石石石石石石石石石石石石石石石石石石石石石石石石石石石石石石石石石石石石石石石石石石石石
道道土花土道土花土石石石石石石石石石石石石石石石石石石石石石石石石石石石石石石石石石石石石石石石石石石石石石石石石石石石石石石石石石石石石石石石石石石石石石石石石石石石石石石石石石石石水水水石石石石石石石石石石石石石石石石石石石石石石石石石石石石石石石石石石石石石石石石石石石石石石石石石石石石石
道道道道道道道土土石石石石石石石石石石石石石石石石石石石石石石石石石石石石石石石石石石石石石石石石石石石石石石石石石石石石石石石石石石石石石石石石石石石石石石石石石石石石石石石石石石石石石石水水水石石石石石石石石石石石石石石石石石石石石石石石石石石石石石石石石石石石石石石石石石石石石石石石石石石
道道道道道道道土土石石石石石石石石石石石石石石石石石石石石石石石石石石石石石石石石石石石石石石石石石石石石石石石石石石石石石石石石石石石石石石石石石石石石石石石石石石石石石石石石石石石石石石石石石水水石石石石石石石石石石石石石石石石石石石石石石石石石石石石石石石石石石石石石石石石石石石石石石石石
道道道道道道道土土石石石石石石石石石石石石石石石石石石石石石石石石石石石石石石石石石石石石石石石石石石石石石石石石石石石石石石石石石石石石石石石石石石石石石石石石石石石石石石石石石石石石石石石石石石石水水水石石石石石石石石石石石石石石石石石石石石石石石石石石石石石石石石石石石石石石石石砂砂砂石石
树道道道道飾飾飾飾石石石石石石石石石石石石石石石石石石石石石石石石石石石石石石石石石石石石石石石石石石石石石石石石石石石石石石石石石石石石石石石石石石石石石石石石石石石石石石石石石石石石石石石石石石石石石石水水水石石石石石石石石石石石石石石石石石石石石石石石石石石石石石石石石石石石石砂砂砂砂砂砂
树無道無無飾飾飾飾石石石石石石石石石石石石石石石石石石石石石石石石石石石石石石石石石石石石石石石石石石石石石石石石石石石石石石石石石石石石石石石石石石石石石石石石石石石石石石石石石石石石石石石石石石石石石石石石石水水水水水水石石石石石石石石石石石石石石石石石石石石石石石石石石石石石砂砂砂砂砂砂砂
树道道道道無無無無石石石石石石石石石石石石石石石石石石石石石石石石石石石石石石石石石石石石石石石石石石石石石石石石石石石石石石石石石石石石石石石石石石石石石石石石石石石石石石石石石石石石石石石石石石石石石石石石石水水水水水水石石石石石石石石石石石石石石石石石石石石石石石石石石石石砂砂砂砂水水砂砂
树道道道道無门無無土土石石石石石石石石石石石石石石石石石石石石石石石石石石石石石石石石石石石石石石石石石石石石石石石石石石石石石石石石石石石石石石石石石石石石石石石石石石石石石石石石石石石石石石石石石石石石石石石石石石石水水石石石石石石石石石石石石石石石石石石石石石石石石石石石石砂砂砂水水水水水
树道道道道道道道道道道道石石石石石石石石石石石石石石石石石石石石石石石石石石石石石石石石石石石石石石石石石石石石石石石石石石石石石石石石石石石石石石石石石石石石石石石石石石石石石石石石石石石石石石石石石石石石石石石石石石水水石石石石石石石石石石石石石石石石石石石石石石石石石石石砂砂砂水水水水水水
土道道道道道道道道道道道石石石石石石石石石石石石石石石石石石石石石石石石石石石石石石石石石石石石石石石石石石石石石石石石石石石石石石石石石石水水水水石石石石石石石石石石石石石石石石石石石石石石石石石石石石石石石石石石石石水水水水水水石石石石石石石石石石石石石石石石石石石石石石砂砂砂砂水水水水水水
花道道道道土花土花土道道石石石石石石石石石石石石石石石石石石石石石石石石石石石石石石石石石石石石石石石石石石石石石石石石石石水水水水水水水水石石石石水水石石石石石石石石石石石石石石石石石石石石石石石石石石石石石石石石石石水水水水水水石石石石石石石石石石石石石石石石石石石石石砂砂砂砂水水水水水水水
土道道道道花土花土花道道石石石石石石石石石石石石石石石石石石石石石石石石石石石石石石石水水水水水水水水水水水水水水水水水水水石石石石石石石石石石石石石石水水石石石石石石石石石石石石石石石石石石石石石石石石石石石石石石石石石石石石水水石石石石石石石石石石石石石石石石石石石石石砂砂砂砂水水水水水水水
道道道道道土土土土標道道石石石石石草草草草石石石石石石石石石石石石石石石石石石石石石石石石石石石石石石石石石石石石石石石石石石石石石石石石石石石石石石石石石水石石石石石石石石石石石石石石石石石石石石石石石石石石石石石石石石石石石水水水水水水水水水树树树树树石石石石石石石石石石砂砂砂水水水水水水水
道道道道道土土土土土道道石石石石石草草草草石石石石石石石石石石石石石石石石石石石石石石石石石石石石石石石石石石石石石石石石石石石石石石石石石石石石石石石石石石水水石石石石石石石石石石石石石石石石石石石石石石石石石石石石水水水水水水水水水水水水水水树树树树树树树树树树树道道道道砂砂砂水水水水水水水
树树树土土土土土土土道道道道土土土土土草草石石石石石石石石石石石石石石石石石石石石石石石石石石石石石石石石石石石石石石石石石石石石石石石石石石石石石石石石石石石石水水石石石石石石石石石石石石石石石石石石石石石石石石石石水水水水水水水石石树树树水水水水水水树树树树树树树道道道道砂砂砂砂砂水水水水水
土土树土土土土土土土道道道道土土土土土草草石石石石石石石石石石石石石石石石石石石石石石石石石石石石石石石石石石石石石石石石石石石石石石石石石石石石石石石石石石石石石石水水石石石石石石石石石石石石石石石石石石水水水水水水石石石石石石石石树树树树水水水水水水树树树树树树土道道土土土土土砂砂砂水水水水
飾飾树树树树树树树树树树树树树树树树树草草土土土土石石石石石石石石石石石石石石石石石石石石石石石石石石石石石石石石石石石石石石石石石石石石石石石石石石石石石石石石石石石石水水水水水水水水水水水水水水水水水水石石石石石石石石石石石石石石树树树树树树树树水水树树树树树树土道道土土土土土土砂砂砂水水水
無無花土花土树树树树树树树树树树树树树草草土土土土石石石石石石石石石石石石石石石石石石石石石石石石石石石石石石石石石石石石石石石石石石石石石石石石石石石石石石石石石石石石石石石石石石石石石石石石石石石石石石石石石石石石石石石石石石石石树树树树树树树树水水水水水水水水土道道土飾飾飾飾土土砂砂水水水
土土土花土花树树树树树树树树树树树树树草草稂稂土土石石石石石石石石石石石石石石石石石石石石石石石石石石石草草草草草草石石石石石石石石石石石石石石石石石石石石石石石石石石石石石石石石石石石石石石石石石石石石石石石石石石石石石石石石石石树树树树树树树树树水水水水水水水水土道道土飾飾飾飾土土砂砂砂水水
土土花土花土树树树石石石石石石石石石石草草稂稂土土石石石石石石石石石石石石石石畑畑畑畑畑畑畑畑畑畑畑石石草草草草草草石石石石石石石石石石石石石石石石石石石石石石石石石石石石石石石石石石石石石石石石石石石石石石石石石石石石石石石石石石树树树树树树树树树树树树树树树水水土道道土無無無無土土树砂砂砂砂
树树树树树树树树树石石石石石石石石石石草草稂稂土土石石石石石石石石石石石石石石畑畑畑畑畑畑畑畑畑畑畑草草草草树树草草土土石石石石石石石石土土草草石石石石石石石石石石石石石石石石石石石石石石石石石石石石石石石石石石石石石石石石石石石石树树树树树树树树树树树树树树树水水土道道土無门無無土土树树树砂砂
畑畑畑树树树树树树石石石石石石石石土土土土土土土土石石石石石石石石石石石石石石畑畑畑畑畑畑畑畑畑畑畑草草草草树树草草土土石石石石石石石石土土草草石石石石石石石石石石石水水水水水水石石石石石石石石石石石石石石石石石石石石石石石石石石石树树树树树树树树树树树树树树树水水土道道道道道道道道道树树树树树
畑畑畑树树树树树树石石石石石石石石土土土土土土土土石石石石石石石石石石石石石石畑畑畑畑畑畑畑畑畑畑畑草草树树树树树树土土草草土土土土道道道道草草草草草草石石石石石石石水水水水水水石石石石石石石石石石石石石石石石石石石石石石石石石石树树树树树树树树树树树树树树树树水水土道道道道道道道道道树树树树树
畑畑畑树树树树树树石石石石石石石石土土土土树树土土石石石石石石石石石石石石石石畑畑畑畑畑畑畑畑畑畑畑草草树树树树树树土土草草土土土土道道道道草草草草草草石石石石石石石水水水水水水石石石石石石石石石石石石石石石石石石石石石石石石石石树树树树树树树树树树树树树树树树水水水水水水水水水水橋橋水水水水水
畑畑畑树树树树树树石石石石石石石石土土草草树树土土石石石石石石石石石石飾飾飾飾畑畑畑畑畑畑畑畑畑畑畑草草草草土土树树树树草草草草树树土土道道道道草草草草石石石石石石石水水水水水水石石石石石石石石石石石石石石石石石石石石石石石石石石树树树树树树树树树树树树树树树树水水水水水水水水水水橋橋水水水水水
畑畑畑树树树树石石石石石石石石石石土土草草树树土土石石石石石石石石石石飾飾飾飾畑畑畑畑畑畑畑畑畑畑畑草草草草土土树树树树草草草草树树土土道道道道草草草草石石石畑畑畑畑畑畑畑水水水石石石石石石石石石石石石石石石石石石石石石石石石石树树树树树树树树树树树树树树树树树树树树树树树树草土土土土土草草草草
畑畑畑树树树树石石石石石石石石石石石石草草稂稂稂稂石石石石石石石石石石無無無無土树树树水水水水水水树树树树树树土草草草草土土树树树树树树花土道道草草石石石石石畑畑畑畑畑畑畑水水水水水水水石石石石石石石石石石石石石石石石石石石石石树树树树树树树树树树树树树树树树树树树树树树树土土草草草草草草草草草
畑畑畑树树树树石石石石石石石石石石石石草草稂稂稂稂石石石石石石石石石石無门無無土树树树水水水水水水树树树树树树土草草草草土土树树树树树树花土道道草草石石石石石畑畑畑畑畑畑畑水水水水水水水石石石石石石石石石石石石石石石石石石石石石树树树树树树树树树树树树树树树树树树树树树树树水水土草土草草草草草草
畑畑畑树树树树石石石石石石石石石石草草草草稂稂稂稂石石石石石石石石土土土土土土土树树树水水水水水水树树树树树树树树树树树树树树树树树草草土土道道土土石石石石石畑畑畑畑畑畑畑水水水水水水水水水石石石石石石石石石石石石石石石石石石树树树树树树树树树树树树树树树树树树树树树树树树水水土土草土土草草草草
树树树树树树树石石石石石石石石石石草草草草稂稂稂稂石石石石石石石石土土土土土土土树土土水水水水水水树树树树树树树树树树树树树树树树树草草土土道道土土石石石石石畑畑畑畑畑畑畑水水水水水水水水水石石石石石石石石石石畑畑畑畑畑畑畑石树树树树树树树树树树树树树树树树树树树树树树树树水水草土树树土草草水水
树树树树树树树石石石石石石石石石石石石草草草草草草草草土土土土道道道道道道道道道無道道土土土土草草草草草草土土無土土花土树树树树草草草草土土道道石石石石石石石畑畑畑畑畑畑畑飾飾飾飾水水水水水石石石石石石石石石石畑畑畑畑畑畑畑树树树树树树树树树树树树树树树树树树树树树树树树树土水土草树树土草土草草
树树树树树石石石石石石石石石石石石石石草草草草草草草草土土土土道道道道道道道道道無道道土土土土草草草草草草土土無土土花土树树树树草草草草土土道道石石石石石石石畑畑畑畑畑畑畑無门無無水水水水水石石石石石石石石石石畑畑畑畑畑畑畑树树树树树树树树树树树树树树树树树树树树树树树树树土草土草土土草草草草草
树树树树树石石石石石石石石石石石石石石石石石石石石石石石石石石石石土土土土土土土無道道道道道道道道無道道道道道無道道道道道道道道道道道道道道道道石石石石石石石石石石草草草草土土土土草草石石石石石石石水水水水水水畑畑畑畑畑畑畑树树树树树树树树树树树树树树树树树树树树树树树树树树草土土草草土土草土草
树树树树树石石石石石石石石石石石石石石石石石石石石石石石石石石石石無無無土無無無無道道道道道道道道無道道道道道無道道道道道道道無道道道道道道道道石石石石石石石石石石草草草草土土土土草草石石石石石石石水水水水水水畑畑畑畑畑畑畑树树树树树树树树树树树树树树树树树树树树树树树树树树土草土土草草草草草草
树树树树树石石石石石石石石石石石石石石石石石石石石石石石石石石石石草草草草草草草草树树土土土土土土無土土草草草草草草土土土土土無土土土土土土道道道道道無道道道道道道草草土土土土土土草草石石石石石石石水水水水水水畑畑畑畑畑畑畑树树树树树树树树树树树树树树树树树树树树树树树树树树树草草草土土草草土草
树树树石石石石石石石石石石石石石石石石石石石石石石石石石石石石石石草草草草草草草草树树無無無土無無無土土草草草草草草土土土土土無土土土土土土道道道道道無道道道道道道草草土土土土土土草草石石石石石石石水水水水水水畑畑畑畑畑畑畑树树树树树树树树树树树树树树树树树树树树树树树树树树树树树土土土草草草草
树树树石石石石石石石石石石石石石石石石石石石石石石石石石石石石石石石石草草草草草草土土草草土土石石草草草土土石石石石石石石石石石石石石石石石石石草草草草草草草草道道道道道道道道道道道道道道道道道道道草草土土飾飾飾飾草草树树树树树树树树树树树树树树树树树树树树树树树树树树树树树树树树树树土土土土土
树树树树树石石石石石石石石石石石石石石石石石石石石石石石石石石石石石石草草草草草草土土草草土土石石草草草土土石石石石石石石石石石石石石石石石石石草草草草草草草草道道道道道道道道道道道道道道道道道道道草草土土無门無無草草树树树树树树树树树树树树树树树树树树树树树树树树树树树树树树树树树树树树树树树
树树树树树石石石石石石石石石石石石石石石石石石石石石石石石石石石石石石石石草草土土草草土土土土石石石石石石石石石石石石石石石石石石石石石石石石石草草草草草草草草草草草草草草草草草草草草草草草草草道道树树道道道道道道土树树树树树树树树树树树树树树树树树树树树树树树树树树树树树树树树树树树树树树树树
树树树树树树树石石石石石石石石石石石石石石石石石石石石石石石石石石石石石石草草土土草草土土土土石石石石石石石石石石石石石石石石石石石石石石石石石草草草草草草草草草草草草草草草草草草草草草草草草草道道树树道道道道道道土树树树树树树树树树树树树树树树树树树树树树树树树树树树树树树树树树树树树树树树树
树树树树树树树石石石石石石石石石石石石石石石石石石石石石石石石石石石石石石石石石石石石石石石石石石石石石石石石石石石石石石石石石石石石石石石石石石石石石石石石石石石石石石石石石石石石石石石石石石道道草草道道土土土土土树树树树树树树树树树树树树树树树树树树树树树树树树树树树树树树树树树树树树树树树
树树树树树树树石石石石石石石石石石石石石石石石石石石石石石石石石石石石石石石石石石石石石石石石石石石石石石石石石石石石石石石石石石石石石石石石石石石石石石石石石石石石石石石石石石石石石石石石石石道道草草道道土土果土土树树树树树树树树树树树树树树树树树树树树树树树树树树树树树树树树树树树树树树树树
树树树树树树树石石石石石石石石石石石石石石石石石石石石石石石石石石石石石石石石石石石石石石石石石石石石石石石石石石石石石石石石石石石石石石石石石石石石石石石石石石石石石石石石石石石石石石石石石石道道草草道道土土土土土树树树树树树树树树树树树树树树树树树树树树树树树树树树树树树树树树树树树树树树树
树树树树树树树树树石石石石石石石石石石石石石石石石石石石石石石石石石石石石石石石石石石石石石石石石石石石石石石石石石石石石石石石石石石石石石石石石石石石石石石石石石石石石石石石石石石石石石石石石道道草草道道土土土土土树树树树树树树树树树树树树树树树树树树树树树树树树树树树树树树树树树树树树树树树
树树树树树树树树树石石石石石石石石石石石石石石石石石石石石石石石石石石石石石石石石石石石石石石石石石石石石石石石石石石石石石石石石石石石石石石石石石石石石石石石石石石石石石石石石石石石石石石石石道道草草道道树树草草草草草草草草草树树树树树树树树树树树树树树树树树树树树树树树树树树树树树树树树树树
树树树树树树树树树石石石石石石石石石石石石石石石石石石石石石石石石石石石石石石石石石石石石石石石石石石石石石石石石石石石石石石石石石石石石石石石石石石石石石石石石石石石石石石石石石石石石石石石石道道草草道道树树草草草草草草草草草树树树树树树树树树树树树树树树树树树树树树树树树树树树树树树树树树树
树树树树树树树树树石石石石石石石石石石石石石石石石石石石石石石石石石石石石石石石石石石石石石石石石石石石石石石石石石石石石石石石石石石石石石石石石石石石石石石石石石石石石石石石石石石石石石石石石道道道道道道道道道道道道道道道草草树树树树树树树树树树树树树树树树树树树树树树树树树树树树树树树树树树
树树树树树树树树树树树树树树树树树树树树树树树树树树树树树树树树树石石石石石石石石石石石石石石石石石石石石石石石石石石石石石石石石石石石石石石石石石石石石石石石石石石石石石石石石石石石石石石石石道道道道道道道道道道道道道道道草草树树树树树树树树树树树树树树树树树树树树树树树树树树树树树树树树树树
树树树树树树树树树树树树树树树树树树树树树树树树树树树树树树树树树树树树石石石石石石石石石石石石石石石石石石石石石石石石石石石石石石石石石石石石石石石石石石石石石石石石石石石石石石石石石石石石石草草草草草草草树树树树土土道道草草树树树树树树树树树树树树树树树树树树树树树树树树树树树树树树树树树树
树树树树树树树树树树树树树树树树树树树树树树树树树树树树树树树树树树树树树石石石石石石石石石石石石石石石石石石石石石石石石石石石石石石石石石石石石石石石石石石石石石石石石石石石石石石石石石石石石草草草草草草草树树树树土土道道草草树树树树树树树树树树树树树树树树树树树树树树树树树树树树树树树树树树
树树树树树树树树树树树树树树树树树树树树树树树树树树树树树树树树树树树树树树石石石石石石石石石石石石石石石石石石石石石石石石石石石石石石石石石石石石石石石石石石石石石石石石石石石石石石石石石石石石石石石土土土树树石石土土道道草草树树树树树树树树树树树树树树树树树树树树树树树树树树树树树树树树树树
树树树树树树树树树树树树树树树树树树树树树树树树树树树树树树树树树树树树树树树石石石石石石石石石石石石石石石石石石石石石石石石石石石石石石石石石石石石石水水水水石石石石石石石石石石石石石石石石石石石石石土土土树树石石土土道道草草树树树树树树树树树树树树树树树树树树树树树树树树树树树树树树树树树树
树树树树树树树树树树树树树树树树树树树树土土土土土土草草草草树树树树树树树树树树石石石石石石石石石石石石石石石石石石石石石石石石石石石石石石石石石水水水水石石水石石石石石石石石石石石石石石石石石石石石石石石石石石石石土土道道草草树树树树树树树树飾飾飾飾树树树树树树树树树树树树树树树树树树树树树树
石树树树树树树树树树树树树树树树树树树土土飾飾飾飾土草草草草树树树树树树树树树树树石石石石石石石石石石石石石石石石石石石石石石石石石石石石石石石水水石石石石水水石石石石石石石石石石石石石石石石石石石石石石石石石石石石土土道道草草树树树树树树树土飾飾飾飾树树树树树树树树树树树树树树树树树树树树树树
石树树树树树树树树树树树树树树树树树树土土無门無無土土土土土土土树树树树树树树树树树石石石石石石石石石石石石石石石石石石石石石石石石石石石石石水水石石石石石石石石石石石石石石石石石石石石石石石石石石石石石石石石石草草土土道道草草树树树树树树土土無無無無树树树树树树树树树树树树树树树树树树树树树树
树树树树树树树树树树树树树树树树树树树花土土土土土土果土土土土土土树树树树树树树树树树树石石石石石石石石石石石石石石石石石石石石石石石石石石水水石石石石石石石石石石石石石石石石石石石石石石石石石石石石石石石石石石草草土土道道土土树树树树树土土土無门無無飾飾飾飾树树树树树树树树树树树树树树树树树树
树树树树树树树树树树树树树树树树树树土土花土土土土土土土土土土李李树树树树树树树树树树树树石石石石石石石石石石石石石石石石石石石石石石石石水水石石石石石石石石石石石石石石石石石石石石石石石石石石石石石石石石石石石草草土土道道土土树树树树土土土土土道土土無门無無树树树树树树树树树树树树树树树树树树
無無無树树树树树树树树树树树树树树树土土土土土土土土土土土土李李水水水树树树树树树树树树树石石石石石石石石石石石石石石石石石石石石石石石石水石石石石石石石石石石石石石石石石石石石石石石石石石石石石石石石石石石草草草草土土道道土土树树飾飾飾飾土土道道道土土道土土树树树树树树树树树树树树树树树树树草
畑畑無树树石石树树树树树树树树树树树草草草草土土土土土土水水水水水水水水树树树树树树树树树石石石石石石石石水水水水水石石石石石石石石石石水水石石石石石石石石石石石石石石石石石石石石石石石石石石石石石石石石石石草草草草土土道道土土树树無门無無道道道道道道道道道道土树树树树树树树树树树树飾飾飾飾树土
土树無树树石石树树树树树树树树树树树草草草草草草草草草草水水水水水水水水水水树树树树树树树树石石石石水水水水石石石水水水石石石石石石石石水石石石石石石石石石石石石石石石石石石石石石石石石石石石石石石石石石石石草草草草土土道道道道道道道道道道道土土土土土土土土道土土土土树树树树树树树树無门無無树土
畑畑無石石石石石石石树树树树树树树树草草草草草草草草草草水水水水水水水水水水水水水水水水水水水水水水水石石石石石石石石水水水水石石石石水水石石石石石石石石石石石石石石石石石石石石石石石石石石石石石石石石石石石草草草草土土道道道道道道道道道道道土水水水水水水土道土土土土树树树树树树树树土土土土树土
土土無石石石石石石石树树树树树树树树草草草草草草草草草水水水水水水水水水水水水水水水水树树树石石石石石石石石石石石石石石石石水水水石石水石石石石石石石石石石石石石石石石石石石石石石石石石石石石石石石石石石草草草草草草草草道道土土树土土土道道道土水土水水华水土道道道道道道道道道道道土土土土土土土土
畑畑無石石石石石石石石石树树树树树树树草草草草草草草草水水水水水水水水水水水水水水水水水树树石石石石石石石石石石石石石石石石石石水水水水石石石石石石石石石石石石石石石石石石石石石石石石石石石石石石石石石石草草草草草草草草道道土土树树土树土道道土水土土水水水土道道道道道道道道道道道土土土土土土土土
树土無石石石石石石石石石树树树树树树树草草草草草草草草水水水水水水水水水水水水水水水水水水树石石石石石石石石石石石石石石石石石石石石石石石石石石石石石石石石石石石石石石石石石石石石石石石石石石石石石石草草草草土土土土道道道道树树树树树土土土道土水水水水水水土道土土树树树树树树树树树树树树树树树树
畑畑無石石石石石石石石石树树树树树树树草草草草草草草草水水水水水水水水水水水水水水水水水水树石石石石石石石石石石石石石石石石石石石石石石石石石石石石石石石石石石石石石石石石石石石石石石石石石石石石石石草草草草土土土土道道道道树树树树土土花土道土土土土土土土土道土树树树树树树树树树树树树树树树树树
土树無石石石石石石石石石树树树树树树树草草草草草草草草草水水水水水水水水水水水水水水水水水树石石石石石石石石石石石石石石石石石石石石石石石石石石石石石石石石石石石石石石石石石石石石石石石石石石石石树树草草稂稂土土树树树树草草树树树树树花土花道道道道道道道道道道树树树树树树树树树树树树树树树树树树
畑畑無石石石石石石石石石树树树树树树树树草草草草草草草草水水水水水水水水水水水水水水水水树树石石石石石石石石石石石石石石石石石石石石石石石石石石石石石石石石石石石石石石石石石石石石石石石石石石石石树树草草稂稂土土树树树树草草树树树树树土花土道道道道道飾飾飾飾树树树树树树树树树树树树树树树树树树树
水水水水水石石石石石石石树树树树树树树树草草草草草草草草草水水水水水水水水水水水水水水水树树石石石石石石石石石石石石石石石石石石石石石石石石石石石石石石石石石石石石石石石石石石石石石石石石石石石石树树树树稂稂草草树树树树草草树树树树树飾飾飾飾道道道道飾飾飾飾树树树树树树树树树树树树树树树树树树树
水水水水水石石石石石石石树树树树树树树树树草草草草草草草草草草水水水水水水水水水水水水树树树石石石石石石石石石石石石石石石石石石石石石石石石石石石石石石石石石石石石石石石石石石石石石石石石石石石石树树树树稂稂草草树树树树草草树树树树树無门無無道道道道無無無無树树树树树树树树树树树树树树树树树树树
石石石石石石石石石石石石石石树树树树树树树草草草草草草草草草草水水水水水水水水水水水树树树树石石石石石石石石石石石石石石石石石石石石石石石石石石石石石石石石石石石石石石石石石石石石石石石水水水水石树树树树稂稂土土树树草草草草飾飾飾飾树土道道道道道道道無门無無树树树树树树树树树树树树树树树树树树树
石石石石石石石石石石石石石石树树树树树树树树草草草草草草草草草草水水水水水水水水水树树树树树石石石石石石石石石石石石石石石石石石石石石石石石石石石石石石石石石石石石石石石石石石石石石水水水石石石石树树树树稂稂土土树树草草草草無门無無树土土土道道道道道道道树树树树树树飾飾飾飾树树树树树树树树树树树
石石石石石石石石石石石石石石树树树树树树树树树草草草草草草草草草水水水水水水水水树树树树树石石石石石石石石石石石石石石石石石石石石石石石石石石石石石石石石石石石石石石石石石石石石水水水石石石石石石树树树树稂稂草草土土土土草草土土土树树树土土土土土道道道土树树水水树土無门無無树树树树树树树树树树树
石石石石石石石石石石石石石石树树树树树树树树树树树草草草草草草草草水水水水水树水水树树树树石石石石石石石石石石石石石石石石石石石石石石石石石石石石石石石石石石石石石石石石石石石水水石石石石石石石石树树树树稂稂草草土土土土草草土花土土树树树花土土土道道土树树土水水土土土土土土树树树树树树树树树树树
石石石石入石石石石石石石石石石石树树树树树树树树树树树草草草草草草水水水水树树树水树树树树石石石石石石石石石石石石石石石石石石石石石石石石石石石石石石石石石石石石石石石石石石水水石石石石石石石石石树树树树稂稂稂稂树树树树土土花土花土树树树树树树土道道树树树土水水土土土土土土树树树树树树树树树树树
石石石石穴石石石石石石石石石石石树树树树树树树树树树树树草草草草草草树水水树树树水水树树石石石石石石石石石石石石石石石石石石石石石石石石石石石石石石石石石嶝嶝嶝嶝嶝嶝嶝嶝嶝水水石石石石石石石石石石树树树树稂稂稂稂树树树树土土土花土树树树树树树树土道道树树土土水水土土树树树树树树树树树树树树树树树
石石石石穴穴穴石石石石石石石石石石石树树树树树树树树树树草草草草草树树水水树树树树水水石石石石石石石石石石石石石石石石石石石石石石石石石石石入石石石石石嶝嶝飾飾飾飾嶝嶝水水水石石石石石石石石石石石树树树树树树稂稂树树树树树树树树树树树树树树树树土道道树树土土土土土土树树树树树树树树树树树树树树树
石石石石石石穴穴石石石石石石石石石石树树树树树树树树树树树草草草树树石水水树树石石石水水石石石石石石石石石石石石石石石石石石石石石石石石石石嶝石石石嶝嶝嶝嶝無门無無水水水石石石石石石石石石石石石石树树树树树树稂稂树树树树树树树树树树树道道道道道道道道树树树草草草草草草树树树树树树树树树树树树树树
石石石石石穴穴穴石石石石石石石石石石石石石石石树树树树树树草草草石石石水水石石石石石石水水石石石石石石石石石石石石石石石石石石石石石石石石石嶝嶝嶝道道道道道道道水水水嶝嶝嶝嶝石石石石石石石石石石石树树树树树树树树树树树树树树树树树树树道道道道道道道道树树树树稂稂稂草土树树树树树树树树树树树树树树
石石穴穴石石穴穴穴穴石石石石石石石石石石石石石树树树树树树石入石石石石水水石石石石石石石水水水水水水石石石石石石石石石石石石石石石石石石石石嶝嶝嶝嶝嶝嶝嶝嶝水道水嶝飾飾飾飾嶝石石石石石石石石石石石树树树树树树树树树树树树树树树树树树树道道草草草草草树树树树稂稂稂稂草草树树树树树树树树树树树树树树
石穴石穴穴穴石穴穴穴石石石石石石石石石石石石石石石石石石石石石石石石石水水石石石石石石石石石石石石水水水水石石石石石石石石石石石石石石石石石石石嶝嶝嶝嶝水水水道嶝嶝飾飾飾飾嶝嶝石石石石石石石石石石石石石石石石石石石石石石石石石石石树树無無無無無草草树树树树稂稂稂稂稂树树树树树树树树树树树树树树树
石穴穴穴石穴石穴穴穴石石石石石石石石石石石石石石石石石石石石石石石石石水水石石石石石石石石石石石石石石石水水水石石石石石石石石石石石石石石石石石嶝嶝水水水嶝嶝道嶝嶝無無無無嶝嶝嶝嶝石石石石石石石石石石石石石石石石石石石石石石石石石树树道道草草草草草树树树树树稂稂稂稂树树树树树树树树树树树树树树树
石穴石穴穴穴穴穴石穴石石石石石石石石石石石石石石石石石石石石石石水水水水水石石石石石石石石石石石石石石石石石水水水水石石石石石石石石石石石石石石水水水嶝嶝嶝嶝道嶝嶝無门無無嶝嶝嶝嶝嶝石石石石石入石石石石石石石石石石石石石石石石石石石石道道草草草草草草树树树树树树草稂树树树树树树树树树树树树树树树
石穴穴石穴石穴穴穴穴石石石石石石石石石石石石石石石石石石石石石石水水水水水石石石石石石石石石石石石石石石石石石石石水水水石石石石石石石石石石石水水嶝嶝嶝嶝道道道道道道道嶝嶝飾飾飾飾嶝嶝嶝嶝石石嶝石石石石石石石石石石石石石石石石石石石石道道草草草草草土土树树树树树草草树树树树树树树树树树树树树树树
穴穴穴石穴穴穴石穴穴石石石石石石石石石石石石石石石石石石石石石石水水水水水石石石石石石石石石石石石石石石石石石石石石石水水水水石石石石石水水水水嶝嶝嶝嶝嶝道飾飾飾飾嶝道嶝嶝無门無無道道嶝嶝嶝嶝嶝石石石石石石石石石石石石草草土土土土土土道道道道道道道土土树树树树树草草树树树树树树树树树树树树树树树
穴穴穴石穴穴石穴穴石石石石石石石石石石石石石石石石石石石石石石石水水石石石石石石石石石石石石石石石石石石石石石石石石石石石石水水水水水水水石石石嶝嶝嶝嶝嶝道飾飾飾飾嶝道嶝嶝嶝道道道道嶝嶝嶝嶝石石石石石石石石石石石石石石草草土土土土土土道道道道道道道土土树树树树树草草树树树树树树树树树树树树树树树
石穴石穴穴石石石石石石石石石石石石石石石石石石石石石石石石石石石水水石石石石石石石石石石石石石石石石石石石石石石石石石石石石石石石石石石石石石石石嶝嶝嶝嶝道無無無無嶝道道道道道嶝嶝嶝嶝石石石石石石石石石石石石石石石石石土土草草石石石石石石石石石道道土土树树树树树草稂树树树树树树树树树树树树树树树
石石石石石石石石石石石石石石石石石石石石石石石石石石石石石石水水水水石石石石石石石石石石石石石石石石石石石石石石石石石石石石石石石石石石石石石石石石嶝嶝嶝道無门無無嶝道嶝嶝嶝嶝嶝石石石石石石石石石石石石石石石石石石石石土土草草石稂稂草草草草土土道道土土树树树树树稂稂稂树树树树树树树树树树树树树树