???????????????
???????????????
???????????????
???????????????
???????????????
???????????????
???????????????
???????????????
???????????????
??_______??????
??_______??????
??_______??????
??_______??????
?????^?????????
???????????????