???????????????
???????????????
???????????????
???????????????
??????___??????
??????___??????
?_____________?
?_____________?
?_____________?
?__???___???__?
?__?_______?__?
?__?_______?__?
?__?_______?__?
???????^???????
???????????????