???????????????
???????????????
???????????????
???????????????
???????????????
???????????????
?______?______?
?______?______?
?______?______?
?______?______?
?______?______?
?______?______?
?_____________?
?????^?????????
???????????????