???????????????
???????????????
???????????????
???????????????
???????????????
???????????????
?____?___??????
?____?___??????
?____?___??????
?_????_????????
?________??????
?________??????
?________??????
?????^?????????
???????????????