石石石石石石石石石石石石石石水水水水水水水水水水水水水圯圯水水水水水水水水水石石石石石石石石石石石石石石石石石石石石石石石石石石树树树树水水树石石石石石石石石石石石石石石石石石石石石石石石石
石石石石石石石石石石石石石石水水水水水水水水水水水水水圯圯水水水水水石水华水石石石石石石石石石石石石石石石石石石石石石石石石石石石树树树水水石石石石石石石石石石石石石石石石石石石石石石石石石
石石石石石石石石石石石石石石石石石石石石石石石嶝嶝嶝嶝嶝嶝树树树水水石水水水石石石石石石石石石石石石石石石石石石石石石石石石石石石石石树水水石石石石石石石石石石石石石石石石石石石石石石石石石
石石石石石石石石石石石石石石石石石石石石石岩石嶝嶝嶝嶝嶝嶝树树树水水石石石石石石石石石石石石石石石石石石石石石石石石石石石石石石石石石石水水石石石石石石石石石石石石石石石石石石石石石石石石石
石石石石石石石石石石石石石石石石石石石石石石石嶝嶝石石石石石石石水水石石石石石石石石石石石石石石石石石石石石石石石石石石石石石石石石石石水水石石石石石石石石石石石石石石石石石石石石石石石石石
石石石石石石石石石石石石石石石石石石石嶝嶝嶝石嶝嶝石嶝嶝嶝嶝嶝石水水石石石石石石石石石石石石石石石石石石石石石石石石石石石石石石石石石石水水石石石石石石石石石石石石石石石石石石石石石石石石石
石石石石石石石石石石石石石石石石石石石嶝岩嶝石嶝嶝石嶝石石石嶝石滝滝石石石石石石石石石石石石石石石石石石石石石石石石石石石石石石石石石石水水石石石石石石石石石石石石石石石石石石石石石石石石石
石石石石石石石石石石石石石石石石嶝石石嶝嶝嶝石嶝嶝石嶝石嶝石嶝石水水石石石石石石石石石石石石石石石石石石石石砂砂砂砂砂砂砂砂砂石石石石石水水石石石石石石石石石石石石石石石石石石石石石石石石石
石石石石石石石石石石石石石石石石石石石石石石石嶝嶝石嶝石石石嶝石滝滝石石石石石石石石石石石石石石石石砂砂砂砂砂砂砂砂砂砂砂砂砂砂砂石石石水水石石石石石石石石石石石石石石石石石石石石石石石石石
石石石石石石石石石石石石石石石石石石石石石土土嶝嶝石嶝嶝嶝嶝嶝石水水石石石石石石石石石石石石石石砂砂砂砂砂砂砂水水水水水砂砂砂砂砂砂石石水水石石石石石石石石石石石石石石石石石石石石石石石石石
石石石石石石石石石石树树树树树石石石石石石土土嶝嶝石石石石石石石水水石石石石石石石石石石石石石砂砂砂砂砂砂水水水水水水水水砂砂砂砂砂砂石水水石石石石石石石石石石石石石石石石石石石石石石石石石
石石石石石石石石树树树树树树树树树石石石石土土草草草草水水水水水水水石石石石石石石石石石石石石砂砂砂砂水水水水水水水水水水水水砂砂砂砂砂水水石石石石石石石石石石石石石石石石石石石石石石石石石
石石石石石石石树树树树树树树树树树树树石石土土草草草草水水水水水水水石石石石石石石石石石石石石砂砂砂水水水水水水水水水水水水水水水橋橋橋水水石石石石石石石石石石石石石石石石石石石石石石石石石
石石石石石石树树树树树树树树树树树树树树树土土土土土土水水石石石石石石石石石石石石石石石石石石砂砂水水水水水水水水水水水水水水水水橋橋橋水水石石石石石石石石石石石石石石石石石石石石石石石石石
石石石石石石树树树树树树树树树树树树树树树土土土土土土水水石岩石石石石石石石石石石石石石石石砂砂砂水水水水水水水水水水水水水水水水砂砂砂砂砂石石石石石石石石石石石石石石石石石石石石石石石石石
石石石石石┫┫树树树树树树树树树树树树树树树树草草土土水水石石石石石石石石石石石石石石石石砂砂砂砂水水水水水水水水水水水水水水水水水水砂砂砂石石石石石石石石石石石石石石石石石石石石石石石石石
石石石石石┫┫树树树树树树树树树树树树树树树树草草土土水水石石┌┻┻┻┻┻┻┻┻┛砂砂砂砂砂砂砂砂水水水水水水水水水水水水水水水水水水水砂砂石石石石石石石石石石石石石石石石石石石石石石石石石
石石┫穴穴┫┫树树树树树树树树树树树树树树树树草草土土水水石石┫砂砂砂砂砂砂砂砂砂砂砂砂砂砂砂砂砂水水水水水水水水水水水水水水水水水水水水砂砂砂石石石石石石石石石石石石石石石石石石石石石石石
石石┫穴穴┫┫树树树树树树树树树树树树树树树树土土土树水水石石┫砂砂砂砂砂砂砂砂砂砂砂砂砂砂砂砂砂水水水水水水水水水水水水水水水水水水水水砂砂砂石石石石石石石石石石石石石石石石石石石石石石石
石石┫穴穴┫┫树树树树树树树树树树┌┻┻┻┐树土土土树水水石┌┛砂砂砂砂砂砂砂砂砂砂砂砂砂砂砂砂砂砂水水水水水水水水水水水水水水水水水水水砂砂砂石石石石石石石石石石石石石石石石石石石石石石石
石石┫穴穴┫┫树树树树树树树树树┌┛砂砂砂┗┻┻║┻┻滝滝┐┫砂砂砂砂砂砂砂砂砂砂砂砂砂砂砂砂砂砂砂水水水水水水水水水水水水水水水水水水水水砂砂砂石石石石石石石石石石石石石石石石石石石石石树
石石┫穴穴┫┫树树树树树树树树┌┛砂砂砂砂砂砂砂砂砂砂水水┣┫砂砂砂砂砂水水砂砂砂砂砂砂砂砂砂砂砂砂水水水水水水水水水水水水水水水水水水水水砂砂砂石石石石石石石石石石石石石石石石石石石石树树
石石┫穴穴┫┫树树树树树树树┌┛砂砂砂砂砂砂砂砂砂砂砂水水┗┛砂砂砂水水水水水砂砂砂砂砂砂砂砂砂砂砂水水水水水水水水水水水水水水水水水水水水砂砂砂石石石石石石石石石石石石石石石石石石石树树树
石石┫穴穴┫┫树树树树树树树┫砂砂砂砂水水砂砂砂砂砂砂橋橋砂砂砂砂水水水水水水水砂砂砂砂砂砂砂砂砂砂砂水水水水水水水水水水水水水水水水水水水水砂砂石石石石石石石石石石石石石石石石石石树树树树
石石┫穴穴┫┫树树树树树树┌┛砂砂砂水水水水水水砂砂砂橋橋砂砂砂水水水水水水水水水水砂砂砂砂砂砂砂砂砂水水水水水水水水水水水水水水水水水水水水砂砂石石石石石石石石石石石石石石石石石树树树树树
石石┫穴穴┫┫树树树树树┌┛砂砂砂水水水水水水水水水水水水水砂水水水水水水水水水水水水水砂砂砂砂砂水水水水水水水水水水水水水水水水水水水水水水砂砂石石石石石石石石石石石石石石石石树树树树树树
石石┫穴穴┫┫树树树树┫┛砂砂砂砂水水水水水水水水水水水水水水水水水水水水水水水水水水水水水水水水水水水水水水水水水水水水水水水水水水水水水水砂砂石石石石石石石石石石石石石石石石树树树树树树
石石┫穴穴┫┫树树树树┫砂砂砂砂水水水水水水水水水水水水水水水水水水水水水水水水水水水水水水水水水水水水水水水水水水水水水水水水水水水水水水水砂砂石石石石石石石石石石石石石石石石树树树树树树
水水┫穴穴┫┫树树树树┫砂砂砂砂水水水水水水水水水水水水水水水水水水水水水水水水水水水水水水水水水水水水水水水水水水水水水水水水水水水水水水砂砂砂石石石石石石石石石石石石石石石树树树树树树树
水水┫穴穴┫┫树┌┻┻┛砂砂砂砂水水水水水水水水水水水水水水水水水水水水水水水水水水水水水水水水水水水水水水水水水水水水水水水水水水水水水水砂砂砂石石石石石石石石石石石石石石石树树树树水水水
滝滝┛穴穴┫┫树┫道道道道砂砂砂水水水水水水水水水水水水水水水水水水水水水水水水水水水水水水水水水水水水水水水水水水水水水水水水水水水水水水砂砂石石石石石石石石石石石石石石石石树树树树水水水
滝滝┻┻┻┛┫树┫道道道道砂砂砂砂砂水水水水水水水水水水水水水水水水水水水水水水水水水水水水水水水水水水水水水水水水水水水水水水水水水水水水砂砂石石石石石石石石石石石石石石石石树树树树水水树
滝滝┻┻┻┻┛树┫道道土土土土土砂砂砂水水水水水水水水水水水水水水水水水水水水水水水水水水水水水水水水水水水水水水水水水水水水水水水水水水水砂砂砂石石石石石石石石石石石石石石树树树树树水水树
滝滝┻┻┻┻┻┻┛道道土土土土土土砂砂砂水水水水水水水水水水水水水水水水水水水水水水水水水水水水水水水水水水水水水水水水水水水水水水水水水水砂砂砂砂石石石石石石石石石石石石石树树树树树水水树
水水水水水水水水土道道土飾飾飾飾土土砂砂水水水水水水水水水水水水水水水水水水水水水水水水水水水水水水水水水水水水水水水水水水水水水水水水水水砂砂砂砂砂砂砂石石石石石石石石石石树树树树树水水树
水水水水水水水水土道道土飾飾飾飾土土砂砂砂水水水水水水水水水水水水水水水水水水水水水水水水水水水水水水水水水水水水水水水水水水水水水水水水水圯圯水水水水砂石石石石石石石石石树树树树树树水水树
树树树树树树水水土道道土無無無無土土树砂砂砂砂水水水水水水水水水水水水水水水水水水水水水水水水水水水水水水水水水水水水水水水水水水水水水水水圯圯水水水水砂石石石石石石石石石树树树树树树水水树
树树树树树树水水土道道土無门館無土土树树树砂砂砂水水水水水水水水水水水水水水水水水水水水水水水水水水水水水水水水水水水水水水水水水水水水水砂砂砂砂砂水水砂砂砂树石石石石石树树树树树树树水水树
树树树树树树水水土道道道道道道道道道树树树树树树水水草水水水水水水水水水水水水水水水水水水水水水水水水水水水水水水水水水水水水水水水水水砂砂砂砂砂砂水水水水水树树石石石树树树树树树树树水水水
树树树树树树水水土道道道道道道道道道树树树树树树水水草土土草草水水水水水水水水水水水水水水水水水水水水水水水水水水水水水水水水水水水水水砂砂砂石石砂水水水水水树树树树树树树树树树树树树水水水
树树树树树树水水水水水水水水水水圯圯水水水水水水水水土土草草土草土土土水水水水水水水水水水水水水水水水水水水水水水水水水水水水水水水水砂砂砂砂石石砂砂砂砂水水水水树树树树树树树树树树树树树树
树树树树树树水水水水水水水水水水圯圯水水水水水水水水草草土草土草草草草草草土水水水水水水水水水水水水水水水水水水水水水水水水水水水水水砂砂砂砂石石砂砂砂砂水水水水树树树树树树树树树树树树树树
树树树树树树树树树树树树树草土土土土土飾飾飾飾草土草草草草草土树土土草土土草土土水水水水水水水水水水水水水水水水水水水水水水水水水水水砂砂砂砂石石石石砂砂砂砂水水树树树树树树树树树树树树树树
树树树树树树树树树树树树土土草草草草草飾飾飾飾草草草草草草草草树树草草土草草草草草草土水水水水水水水水水水水水水水水水水水水水水水水水砂砂砂砂石石石石石树树砂水水树树树树树树树树树树树树树树
树树树树树树树树树树树树水水土草土草草無無無無土水水水草草树草草草草草草草草草土土土草土土水水水水水水水水水水水水水水水水水水水水水水砂砂砂石石石石石石石树树水水树树树树树树树树树树树树树树
树树树树树树树树树树树树水水土土草土土無门無無水水水土草草草草草草草草草草草草草草树树土土土水水水水水水水水水水水水水水水水水水水水水砂砂砂石石石石石石石树树水水树树树树树树树树树树树树树树
树树树树树树树树树树树树水水草土树树土草草水水水土草草草草草土草草草土土土草草土树树草土土土土水水水水水水水水水水水水水水水水水水水水砂砂砂砂石石石石石石树树水水树树树树树树树树树树树树树树
树树树树树树树树树树树树土水土草树树土草土草草土土草土草草土草草草草草草草草草土树树草草草土土水水水水水水水水水水水水水水水水水水水水砂砂砂砂石石石石石石树树水水树树树树树树树树树树树树树树
树树树树树树树树树树树树土草土草土土草草草草草土草土土草草草土草草土土草土土草草草草草土草草土水水水水水水水水水水水水水水水水水水水水水砂砂砂石石石石石石树树水水树树树树树树树树树树树树树树
树树树树树树树树树树树树树草土土草草土土草土草草草草土土草土土水草土土草草草草土土土草土土草土水水水水水水水水水水水水水水水水水水水水水砂砂砂砂石石石石石树树水水水水水水水水水树树树树树树树
树树树树树树树树树树树树树土草土土草草草草草草树树草土土草土水水草草草土草土草草土土草土草草水水水水水水水水水水水水水水水水水水水水水水砂砂砂砂石石石石石树树水水水水水水水水水树树树树树树树
土土土树树树树树树树树树树树草草草土土草草土草树树草草草草草水水草土土草土土草草草树树草土水水水水水水水水水水水水水水水水水水水水水水水水砂砂砂土石石石石树树畑畑畑社畑畑畑水水树树树树树树树
树土土土树树树树树树树树树树树树土土土草草草草土土土土土草草水草草草草草土草土草土树树土水水水水水水水水水水水水水水水水水水水水水水水水水砂砂砂土土土土土土树畑畑畑畑畑畑畑水水树树树树树树树
土土土土土树树树树树树树树树树树树树土土土土土草草草草草土土土土土土土土草草土草土土草水水水水水水水水水水水水水水水水水水水水水水水水水水砂砂砂土土土果土土树畑畑畑畑畑畑畑水水水水水水水水水
土土土土土土树树树树树树树树树树树树树树树树树树树树树树树土土草草草草草草草草草草草水水水水水水水水水水水水水水水水水水水水水水水水水水水砂砂砂土土土土土土树畑畑畑畑畑畑畑水水水水水水水水水
土土土土土土土树树树树树树树树树树树树树树树树树树树树树树树树树树树树树树土土土草草水水水水水水水水水水水水水水水水水水水水水水水水水水水砂砂砂土土土土土土树畑畑畑畑畑畑畑树树树树树树树树树
土土土土土土土树树树树树树树树树树树树树树树树树树树树树树树树树树树树树树树树树树水水水水水水水水水水水水水水水水水水水水水水水水水水水飾飾飾飾飾飾飾飾土土土畑畑畑畑畑畑畑树树树树树树树树树
土土土土土树土树树树树树树树树树树树树树树树树树树树树树树树树树树树树树树树树树树水水水水水水水水水水水水水水水水水水水水水水水水水水水無门無無门無無無土土土畑畑畑畑畑畑畑树树树树树树树树树
土土土土土土土树树树树树树树树树树树树树树树树树树树树树树树树树树树树树树树树树水水水水水水水水水水水水水水水水水水水水水水水水水水水水砂砂树土土土土土土土树树树树树树树树树树树树树树树树树
土土土土土土土树树树树树树树树树树树树树树树树树树树树树树树树树树树树树树树树树水水水水水水水水水水水水水水水水水水水水水水水水水水水砂砂砂树土土土土土土土树树树树树树树树树树树树树树树树树
土土土土土土树树树树树树树树树树树树树树树树树树树树树树树树树树树树树树树树树水水水水水水水水水水水水水水水水水水水水水水水水水水水水砂砂砂树土土树树树树树树树树树树树树树树树树树树树树树树
土土土土土树树树树树树树树树树树树树树树树树树树树树树树树树树树树树树树树树树水水水水水水水水水水水水水水水水水水水水水水水水水水水砂砂砂砂树土土树树树树树树树树树树树树树树树树树树树树树树
树土土土树树树树树树树树树树树树树树树树树树树树树树树树树树树树树树树树树树树水水水水水水水水水水水水水水水水水水水水水水水水水水水砂砂砂树树土土树树畑畑畑社畑畑畑树树树树树树树树树树树树树
土土土树树树树树树树树树树树树树树树树树树树树树树树树树树树树树树树树树树树水水水水水水水水水水水水水水水水水水水水水水水水水水水砂砂砂砂树树土土树树畑畑畑畑畑畑畑树树树树树树树树树树树树树
土树树树树树树树树树树树树树树树树树树树树树树树树树树树树树树树树树树树树树水水水水水水水水水水水水水水水水水水水水水水水水水水砂砂砂砂树树树土土树树畑畑畑畑畑畑畑树树树树树树树树树树树树树
土树树树树草草树树树树树树树树树树树树树树树树树树树树树树树树树树树树树树树水水水水水飾水水水水水水水水水水水水水水水水水水水砂砂砂树树树树树土土树树畑畑畑畑畑畑畑树树树树树树树树树树树树树
土树树树草草草草草树树树树树树树树树树树树树树树树树树树树树树树树树树树树树水水水水飾飾飾水水水水水水水水水水水水水水水水水水砂飾飾飾飾树树树土土树树畑畑畑畑畑畑畑树树垣垣垣垣垣垣垣垣垣垣垣
土土土土土土草草草树树树树树树树树树树树树树树树树树树树树树树树树草草草草草水水土飾飾無飾飾土水土土土水水水水水水水水水水砂砂砂無门無無树树树草草树树土土土土土土土树树垣道道道道道道道道道道
树树树草草土草草草草树树树树树树树树树树树树树树树树树树树树树树草草草草草水水水土飾無無無飾土华土仏土水水水水水水水水水砂砂砂砂砂砂树树树草草草草树树土土土土土土土树树垣道道道道道道道道道道
飾树树树草土土草草草树树树树树树树树树树树树树树树树树草草草草草草草草草草水水水土無無门無無土水土土土水水水水水水水水砂砂砂砂砂砂树树树树草草草草树树土土飾飾飾飾树树树垣飾飾飾道道花土花土花
飾树树树草草土土草草树树树树树树树树树树树树树树树树树草飾飾飾飾草草草水水水水水土土土土土土土水水水水水水水水砂砂砂砂砂砂砂砂树树树树树树草草树树树树土土無门無無石树树垣無门無道道土飾飾飾飾
無树树树树草草土草草树树树树树树树树树树树树树树树树树草無门無無草草草水水水水水水水水圯水水水水水水水水砂砂砂砂砂砂砂砂砂砂树树树树树树树草草树树树树土土土土土土石树树垣道道道道道花飾飾飾飾
無飾飾飾飾草草土土草树树树树树树树树树树树树树树树树树草草草草草水水水水水水水水水水水圯水水水水水水树树树树砂砂砂道道砂砂树树树树树树树树草草树树树树土土土土土土树树树垣飾飾飾道道土無無無無
土無门無無树草土土草树树树树树树树树树树树树树树树树树树树草草草水水水水水水水水水水水圯水水水水树树树树树树树树土道道土树树树树树树树树稂稂稂稂树树树树树树树土土树树树垣無门無道道花無门学無
土土道土土树树土草草树树树树树树树树树树树树草土土土草土土草草草草草草草草草草草草树树道道树水水树树树树树树树树土道道土树树树树树树稂稂稂稂稂稂稂树树树石石树土土树石石垣道道道道道土花土花土
道道道道道土树土树树树树树树树树树飾飾飾飾树土土草土土土草草草草草草草草草草草草草树树道道树水水树树树树树树树树土道道土树树树树树稂稂稂稂稂稂稂稂稂稂树石石树土土树石石垣飾飾飾飾道道道道道道
土土土土道土土土土树树树树树树树树無门無無树土土树树树树树草草树树土土草草草草土土树树道道水水水树树树树树树树树土道道草树树树树稂树稂稂稂树稂稂稂稂稂稂稂草草土土草草草垣飾飾飾飾道道飾飾飾飾
水水水土道土土土土树树树树树树树树土土土土树土土树树树树树草草树树土土草草草草土土土土道道水水水土土土土土土土土土道道草草草稂稂稂稂树稂稂稂稂稂稂稂稂稂稂稂草土土土草草垣無無無無道道飾飾飾飾
水华水土道道道道道道道道道道道土土土土土土土土土草草草草草草草道道道道树树树树道道道道道道橋橋道道道道道道道道道道道道草草稂稂树稂稂稂稂草道道道草草草稂稂稂草草土土土土垣無门無無道道無無無無
土水水土道道道道道道道道道道道土土土土土土土土土草草草草草草草道道道道树树树树道道道道道道水水道道道道道道道道道道道道草草稂稂稂稂稂稂草草道道草草草道稂稂稂稂草草土垣垣垣垣道道道道道無门館無
水水水土道土土树树树树树树树树树树树树树树树树树土土树树树草草树树树树树树树树土土土土土土水水土土土土土土土土土土道道道道草草草草草道道道道道稂稂道道道道道道道道道道道道道道道道道道道道道道
土土土土道土树树树树树树树树树树树树树树树树树树土土树树树草草树树树树树树树树土土树树树树水水树树树树树树树树树土道道道道草草草草道道道道道道稂稂道道道道道道道道道道道道道道道道道道道道道道
道道道道道树树树树树树树树树树树树树树树树树树树草草草草草草草树树飾飾飾飾树树草草树树水水水水树树树树树树树树树树树草草草稂稂稂稂草草草草草稂稂稂稂稂稂草草草草草草垣垣垣垣道飾飾飾飾飾飾道道
飾飾飾飾树树树树树树树树树树树树树树树树树树树树草草草草草草草树树無门無無树树草草树树水水水水树树树树树树树树树树树草草稂稂稂稂稂稂草草草草稂树稂稂稂稂草草草草草草土土垣道道飾飾飾飾飾飾道道
飾飾飾飾树树树树树树树树树树树树树树树树树树树树树树土土树树树树树土土树树树树草草树树水水树树树树树树树树树树树树树树树稂稂稂稂稂稂稂稂稂稂树树树稂稂稂草树树树草草土土垣道道無無無無無無道道
無無無無树树树树树树树树树树树树树树树树树树树树树树土土树树树树树土土树树树树草草树树水水树树树树树树树树树树树树树树树树稂稂稂稂稂稂稂稂稂树树树树稂稂树树树树树草土土垣道道無無门競無無道道
無门館無┏┲┲┳┳┳┳┳┱┱┓树树树树树树树树树树树土土土土土土土土土草草草草草草树树水水树树树树树树树树树树树树树树树树树树稂稂稂稂稂树树树树树树树树树树树树树树树树垣道道道道道道道道道道
道道树┏┲┲┳土飾飾飾飾┫┫┫树树树树树树树树树树树土土土土土土土土土草草草草草草树树水水树树树树树树树树树树树树树树树树树树树树草草树树树树树树树树树树树树树树树树树垣道土土土土土土土道道
道土树┣┣┣树土無门無無┫┫┫树树树树树树树树树树树树树树树树树树树树树树树树树树树树水水树树树树树树树树树树树树树树树树树树树树草草树树树树树树树树树树树树树树树树树垣道土花土花土花土道道
土树树┣┣┣土土土土土土┫┫┫树树树树树树树树树树树树树树树树树树树树树树树树树树树树水水树树树树树树树树树树树树树树树树树树树树草草树树树树树树树树树树树树树树树树树垣道土土花土花土土道道
树树树┣┣┣土土土土土土┫┫┫树树树树树树树树树树树树树树树树树树树树树树树树树树树树水水树树树树树树树树树树树树树树树树树树树树草草树树树树树树树树树树树树树树树树树垣道土土土土土土土道飾
树树树┣┣┣土土草草草草┫┫┫树树树树树树树树树树树树树树树树树树树树树树树树树树水水水水树树树树树树树树树树树树树树树树树树树树土土树树飾飾飾飾土土土树树树树树树树树垣道土水水水水水土道飾
树树树┣┣┣土草草稂草草┫┫┫树树树树树树树树树树树树树树树树树树树树树树树树树树水水水水树树树树树树树树树树树树树树树树树树树树土土树树無门無無土果土树树树树树树树树垣道土水华水水水土道無
树树树┣┣┣草草草稂草树┫┫┫树树树树树树树树树树树树树树树树树树树树树树树树树树水水树树树树树树树树树树树树树树树树树树树树树树土土土土土土土土土土土树树树树树树树树垣道土水水水华水土道無
树树树┣┣┣稂草稂稂草树┫┫┫树树树树树树树树树树树树树树树树树树树树树树树树树树水水树树树树树树树树树树树树树树树树树树树树树树土土土土土土土土土土土树树树树树树树树垣道土土土土土土土道道
树树树┣┣┣稂稂稂草草树┫┫┫树树树树树树树树树树树树树树树树树树树树树树树树树树树树树树树树树树树树树树树树树树树树树树树树树树树树树树树树树树树树树树树树树树树树树垣道道道道道道道道道道
树树树┣┣┣稂稂稂草草草┫┫┫树树树树树树树树树树树树树树树树树树树树树树树树树树树树树树树树树树树树树树树树树树树树树树树树树树树树树树树树树树树树树树树树树树树树树垣垣垣垣垣垣垣垣垣垣垣
