树树土土土水水土土土土土土树树树树土土土土土土土土土水水水水水水水水水水水水水水水水水水水水水水水水水水水水土土飾飾飾飾道道
树树土土土水水土土土土土土树树树树土土土土土土土土土水水水水水水水水水水水水水水水水水水水水水水水水水水水水土土飾飾飾飾道道
土土土土土水水土土土土土土土土土土土土土土土土土树树水水水水水草树树树树树树树树树树树树树树树树树树树树水水土土無無無無道道
土土土土土水水土土土土土土土土土土土土土土土土土树树水水水草草草树树树树树树树树树树树树树树树树树树树树水水土土無门館無道道
树树土土土水水土土土树树树树树草草草草草草草土土树树水水水草草草草草树树树树树树树树树树道道道道道道道道橋橋道道道道道道道道
树树土土土水水土土树树树树树树草草草草草草草土土树树水水水草草草草草树树树树树树树树树树道道道道道道道道橋橋道道道道道道道道
树树树土土水水土土树树树树树树树树树树树树树土土树树水水水草草草草草草草树树树树树树树树道道树树树树树树水水土土土土土土土土
树树树土土水水土树树树树树树树树树树树树树树土土树树水水水草草草草草草草树树树树树树树树道道树树树树树树水水土土土土土土土土
树树树树土水水树树树树树树树树树树树树树树树土土树树水水水土土土土土土土树树树树树树树树道道树树树树树树水水水水水水水水水水
树树树树树水水树树树树树树树树树树树树树树树土土树树水水水土土土土土土土树树树树树树树树道道树树树树树树水水水水水水水水水水
树树树树树水水树树树树树树树树树树树树树树树土土土土橋橋橋道道道道道道道道道道道道道道道道道树树树树树树树树树树树树树树树树
树树树树树水水树树树树树树树树树树树树树树树土土土土橋橋橋道道道道道道道道道道道道道道道道道树树树树树树树树树树树树树树树树
树树树树树水水水水水树树树树树树树树树树树树树树树树水水水土土土土道道土土土树树树树树树树树树树树树树树树树树树树树树树树树
树树树树树水水水水水树树树树树树树树树树树树树树树树水水水土土土土道道土土土树树树树树树树树树树树树树树树树树树树树树树树树
树树树树树树树树水水树树树树树树树树树树树树树树树树水水水土土土土道道土土土树树树树树树树树树树树树树树树树树树树树树树树树
树树树树树树树树水水树树树树树树树树树树树树树树树树水水水土土土土道道土土土树树树树树树树树树树树树树树树树树树树树树树树树
树树树树树树树树水水树树树树树树树树树树树树树树树树水水水草草草草道道土土土树树树树树树树树树树树树树树树树树树树树树树树草
树树树树树树树树水水树树树树树树树树树树树树树树树树水水水草草草草道道土土土树树树树树树树树树树树树树树树树树树树树树树草草
树树树树树树树树水水水水水水水水水水水树树树树树树树水水水草草草草道道土土土树树树树树树树树树树树树树树树树树树树树树树草草
树树树树树树树树水水水水水水水水水水水树树树树树树树水水水草草草草草草草草草草树树树树树树树树树树树树树树树树树树树草草草草
树树树树树树树树树树树树树树树树树水水树树树树树树树水水水草草草草草草草草草草树树树树树树树树树树树树树树树树树草草草树草草
树树树树树树树树树树树树树树树树树水水树飾飾飾飾飾飾水水水草草草草草草草草草草树树树树树树树树树树树树树树树树稂稂树草草树草
树树树树树树树树树树树树树水水水水水水树飾飾飾飾飾飾水水水土土土土道道草草草草树树树树树树树树树树树树树树树稂稂稂稂树草稂稂
树树树树树树树树树树树树树水水水水水水树無無無無無無水水水土土土土道道草草草草树树树树树树树树树树树树树树稂稂稂树树稂树稂树
树树树树树树树树树树树树树水水飾飾飾飾飾飾無门競無無水水水飾飾飾飾道道草草草草树树树树树树树树树树树树树稂稂稂树稂稂稂稂稂稂
树树树树树树树树树树树树树水水飾飾飾飾飾飾土道道土土水水水飾飾飾飾道道树树树树树树树树树树树树树树树树树稂树树稂树树稂树树树
树树树树树树树树树树树树树水水無無無無無無土道道土土水水水無無無無道道树树树树树树树树树树树树树树树树树树稂稂稂稂稂树稂草草
树树树树树树树树树树树树树水水無無门学無無土道道土土水水水無门館無道道树树树树树树树树树树树树树树树树树稂树稂稂稂树稂稂草草
树树树树树树树树树树树树树水水道道道道道道道道道道道橋橋橋道道道道道道树树树树树树树树树树树树树树树稂稂稂稂稂树稂稂稂稂树草
树树树树树树树树树树树树树水水道道道道道飾道道道道道橋橋橋道道道道道道树树树树树树树树树树树树树稂稂稂树稂树树树树树树稂稂稂
树树树树树树树树树树树树树水水道道土土飾飾飾土土道道水水水道道道飾飾飾飾树树树树树树树树树树树树稂树草草树稂草草稂草草树树稂
树树树树树树树树树树树树树水水道道土飾飾無飾飾仏道道水水水道道道飾飾飾飾树树树树树树树树树树稂树稂稂树树草草稂树草树草草稂树
树树树树树水水水水水水水水水水道道土飾無無無飾土道道水水水道道道無無無無树树树树树树树树树树稂稂稂树草稂草树稂草草稂草草草稂
树树树树树水水水水水水水水水水道道土無無门無無土道道水水水道道道無门買無树树树树树树树树树树树稂树稂草树草草稂树草树草草草稂
树树树树树水水树树树树树树树树道道道道道道道道道道道水水水道道道道道道道道道树树树树树树树树稂稂树稂树草草稂树草草稂草草树稂
树树树树树水水树树树树树树树树道道道道道道道道道道道水水水道道道道道道道道道树树树树树树树稂树草稂稂草草树稂草草树稂草树草稂
树树树树树水水树树树树树树树树土土土道道土土飾飾飾飾水水水道飾飾飾飾土土道道树树树树树树稂草草树稂树草稂稂树草树稂草树草草草
树树树树树水水树树树树树树树树土土土道道土土無门無無水水水道無门無無土土道道树树树树草草稂树草稂稂草草树草草草草树稂草树水树
树树树树树水水水树树树树树树草土土土道道道道道道道道橋橋橋道道道土土土土道道树树草草草稂草草草树稂草草稂草树草草草稂树草水水
树树树树树水水水树树树树树草草土土土道道道道道道道道橋橋橋道道道土土土土道道树树草草草草草草草草草树草稂树草水水稂稂稂树树水
树树树树树树水水树树树树树草草草草草道道树树树树树树水水水道道道道道道道道道土土土土土土土土土土土土土土土土土水水水稂稂水水
树树树树树水水水树树树树树草稂树草稂道道树树树树树树水水水道道道道道道道道道土土土土土土土土土土土土土土土土土水水水树树水树
树树树树树水水水树树树树树草树草树稂道道草树树水树树水水水水水水水水土土道道树树草草草草草草草草草草草草草土土树树水水水水树
树树树树树水水树树树树树树稂草草草树稂稂树稂水树水树水水水水水水水水土土道道树树草草草草草草草草草草草草草土土树树水稂树树树
树树树树水水水树树树树树树树草稂树草草水树树水草水树水水水水水水水水水水道道树树树树树树树树树树树树树树树土土土草稂水草土土
树树树树水水水树树树树树树树树稂稂稂草草水草稂水树水水水水水水水水水水水道道树树树树树树树树树树树树树树树土土草草水稂稂水草
树树树树水水树树树树树树树树树树树稂稂稂树稂水树树草树水仏土土土土土水水道道树树树树树树树树树树树树树树树树树水水水水水水水
树树树树水水水树树树树树树树树树树稂草树树草稂水树土草水土土飾土土土水水道道树树树树树树树树树树树树树水水水水水水水水水水水
树树树树水水水树树树树树树树树树树稂草稂树草水水草稂草橋土飾飾飾土土水水道道树树树树树树树树树树树树水水水水水水水水水水水水
水水树树树水水水水树树树树树树树稂稂稂树草水草水水土土水飾飾飾飾飾土水水道道树树树树树树树树树树树树水水水水水水水水树树树树
水水树树树树水水水水树树树稂稂稂树稂草草树水树水仏草树水無無無無無土水水道道树树树树树树树树树树树树水水水树树树树树树树树树
水水树树树树树树水水水树树稂稂树树草稂草草水树水草土草稂無無门無無土水水道道树树树树树水水水水水水水水水树树树树树树树树树树
水水树树树树树树树水水水树树草稂稂稂草稂树水水水水稂水水道道道道道道橋橋道道树树树树水水水水水水水水水水树树树树树树树树树树
水水树树树树树树树树水水水水草水稂稂水水水稂水水水水水水道道道道道道橋橋道道树树树水水水水水┏┳┳┳┳┳┳┳┓树树树树树树树
水水树树树树树树树树树水水水水水稂水稂水草水草树草水水水水水水水水水水水圯圯水水水水水水水┏┳┏┳┳┳┳┓穴┱┱┓树树树树树
水水树树树树树树树树树树树草草草稂草稂树水水草树草水水水水水水水水水水水圯圯水水水水水┏┲┲┏┳穴飾穴穴┫穴┫┫┫树树树树树
水水树树树树树树树树树树树草树树树水树水稂稂水草水水水水水水水水水水水水土树树水树树树┣┣┣┣穴飾飾飾穴┫穴┫┫┫树树树树树
水水树树树树树树树树稂稂稂稂水水稂水草水稂草水水水水水水水水水水水水水水土树土水树树树┣┣┣┣飾飾飾飾飾┫穴┫┫┫树树树树树
橋橋土土树树树树树树稂树树水稂树稂水稂水草草水水水水水水水水水水水水水水土土土水树树树┣┣┣┣無無無無無┫┌┛┫┫树树树树树
橋橋土土树树树树树树稂稂草树水稂树水稂水水草水水水水水水水水水水水水水水水土树树水树树┣┣┣┣無無门無無┫┫┌┛┫树树树树树
水水土土树树树树树树水水稂稂草稂草水树树草飾飾飾飾水水水水水水水水水水水土土树水水树树┣┣┣┗┻┻║┻┻┛┫┫┌┛树树树树树
水水土土树树树树树树树水水水水树草草草树無飾飾飾飾無水水水水水树树树草草土草水树树树树┣┣┗┻┻┻║┻┻┻┛┫┫树树树树树树
水水土土树树树树树树树水水草水树水稂水水草無门無無水水水水树树水水草土稂稂稂水水水水树┣┗┻┻┻┻║┻┻┻┻┛┫树树树树树树
水水土土树树树树水树水树稂水稂树水稂草草草土土树水水水水树水树树草土水水稂稂水树树水树┗┻┻┻┻┻║┻┻┻┻┻┛树树树树树树
水水土土树树树水草草水草稂水稂水草稂草草水草水水水水水树水树树树草树树稂水树水水水水树树树树树树树草稂树树树树树树树树树树树
水水土土树水水稂树草水草树水树水草稂水草水水水水水水水树水树树草土水稂草水水水树水树水树树树树树树草草草草树树树树树树树树树
水水土土草水水水树树水树水水水稂稂草水草水水水水水水水树树树草土土稂水水树水水树树水水树树树树树树树稂树稂草树树树树树树树树
水水土草草草草水水水草水水树草水草水水草水水水水水水树水树草水稂水稂稂稂草草草树树水水树树树树树树树树树稂草树树树树树树树树
