???????????????
???????????????
???????????????
???????????????
???????????????
?????^?????????
?_____________?
?_____?_______?
?_____?_______?
?_____???_?????
?_____?_______?
?_____?_______?
?_____________?
?????^?????????
???????????????