???????????????
???????????????
???????????????
???????????????
???????????????
???????????????
?______^______?
?______?______?
?______?______?
?_????????____?
?________?____?
?________?____?
?________^____?
?????^?????????
???????????????