無無無無無無無無無無無無無無無
無無無無無無無無無無無無無無無
無無無無無無無無無無無無無無無
無無無無無無無無無無無無無無無
無無無無無無無無無無無無無無無
無無無無無無無無無無無無無無無
無無無無無無無無無無無無無無無
無無無無無無無無無無無無無無無
無無道道道道道道道無無無無無無
無無下道道道道道道無無無無無無
無無道道道道道道道無無無無無無
無無道道道道道道道無無無無無無
無無道道道道道道道無無無無無無
無無無無無無無無無無無無無無無
無無無無無無無無無無無無無無無