無無無無無無無無無無無無無無無
無無無無無無無無無無無無無無無
無無無無無無無無無無無無無無無
無無無無無無無無無無無無無無無
無無無無無無無無無無無無無無無
無無無無無無無無無無無無無無無
無道道道道道道無道道道道道道無
無道道道道道道無道道道道道道無
無道道道道道道無道道道道道道無
無無無無無门無無门無道道道道無
無道道道道道道道道無道道道道無
無道道道道道道道道無道道道道無
無道道道道道道道道無道道道道無
無無無無無门無無無無無無無無無
無無無無無無無無無無無無無無無