無無無無無無無無無無無無無無無
無無無無無無無無無無無無無無無
無無無無無無無無無無無無無無無
無無無無無無無無無無無無無無無
無無無無無無無無無無無無無無無
無無無無無無無無無無無無無無無
無無無無無無無無無無無無無無無
無無無無無無無無门無無無無無無
無無道道道道道道道無無無無無無
無無道道道道道道道無無無無無無
無無道道道道無無道無無無無無無
無無道道道道無無道無無無無無無
無無道道道道道道道無無無無無無
無無無無無门無無無無無無無無無
無無無無無無無無無無無無無無無