無無無無無無無無図無無無
無飾飾床床床無床床床無無
無無無無無無無床床床床無
無床床床床床床床床床床無
無床床床床床床床床床床無
無床床床床床床床無無床無
無床床床床床床床床床床無
無床床床床床床床無無床無
無無無無门無無無無無無無