????????????
?ddIII?III??
???????IIII?
?IIIIIIIIII?
?IIIIIIIIII?
?IIIIIII??I?
?IIIIIIIIII?
?IIIIIII??I?
????0???????