無無無無無無無無無無無無
無無無無無無無無無無無無
無無無無無無無無無無無無
無飾飾床床無床床無無無無
無無無無無無床床無無無無
無床床床床床床床無無無無
無床床床床床床床無無無無
無床床床床床床床無無無無
無無無無门無無無無無無無