無無無無無無無無無無無無無無無無無無無無無無無無無無無
無無無無無無無無無無無無無無無無無無無無無無無無無無無
無無無無無無無無無無無無無無無無無無無無無無無無無無無
無無無無無無無無無無無無無無無無無無無無無無無無無無無
無無無無無無無無無無無無無無無無無無無無無無無無無無無
無無無無無無無無無無無無無無無無無無無無無無無無無無無
無無無無無無無無無無無無無無無無無無無無無無無無無無無
無無無無無無無無無無無無無無無無無無無無無無無無無無無
無無無無無無無無無無無無無無無無無無無無無無無無無無無
無無無無無無無無無無無無無無無無無無無無無無無無無無無
無無無無無無無無無無無無無無無無無無無無無無無無無無無
無無無無無無無無無無無無無無無無無無無無無無無無無無無
無無無無無無無無無花土土土土土土土土無無無無無無無無無
無無無無無無無無無土水水水水水水水土無無無無無無無無無
無無無無無無無無無土水花土树土土水花無無無無無無無無無
無無無無無無無無無土水土土仏土花水土無無無無無無無無無
無無無無無無無無無土水土土土土花水土無無無無無無無無無
無無無無無無無無無花水土寺寺寺土水土無無無無無無無無無
無無無無無無無無無土水花寺寺寺土水花無無無無無無無無無
無無無無無無無無無土水土寺寺寺土水土無無無無無無無無無
無無無無無無無無無土水土寺寺寺花水土無無無無無無無無無
無無無無無無無無無土水土寺寺寺土水土無無無無無無無無無
無無無無無無無無無土水土土土土土水土無無無無無無無無無
無無無無無無無無無土水水水圯水水水花無無無無無無無無無
無無無無無無無無無花土土土土土花土土無無無無無無無無無
無無無無無無無無無無無無無门無無無無無無無無無無無無無
無無無無無無無無無無無無無無無無無無無無無無無無無無無