穴穴穴穴穴穴穴穴穴穴穴穴穴穴穴穴穴穴穴穴穴穴穴穴穴穴穴穴穴穴穴穴穴穴穴穴┫┫树树稂稂
穴穴穴穴穴穴穴穴穴穴穴穴穴穴穴穴穴穴穴穴穴穴穴穴穴穴穴穴穴穴穴穴穴穴穴穴┫┫树树稂稂
穴穴穴穴穴穴穴穴穴穴穴穴穴穴穴穴穴穴穴穴穴穴穴穴穴穴穴穴穴穴穴水水水水穴┫┫树树稂稂
穴穴穴穴穴穴穴穴穴穴穴穴穴穴穴穴穴穴穴穴穴穴穴穴穴穴穴穴穴水水水穴穴穴穴┫┫树树稂稂
穴穴穴穴穴穴穴穴穴穴穴穴穴穴穴穴穴穴穴穴穴穴穴穴穴穴穴水水水穴穴┌┻┻┻┛┫树树稂稂
穴穴穴穴穴穴穴穴穴穴穴穴穴穴穴穴穴穴穴穴穴穴穴穴穴穴水水穴穴穴穴┫┌┻入┻┛树树稂稂
穴穴穴穴穴穴穴穴穴穴穴穴穴┌┻┻┻┻┻┻┻┻┻┐穴水水穴穴穴穴穴┫┫稂稂稂稂树树稂稂
穴穴穴穴穴穴穴穴穴穴穴穴┌┛嶝嶝嶝嶝嶝嶝嶝嶝嶝┣水水穴穴穴穴穴穴┫┫稂稂稂稂树树稂稂
穴穴穴穴穴穴穴┌入┐穴┌┛嶝嶝飾飾飾飾嶝嶝嶝水水水穴穴穴穴穴穴穴┫┫树树稂稂树树树树
穴穴穴穴穴穴穴┫嶝┗┻┛嶝嶝嶝無门無無嶝水水水┗┻┐穴穴穴穴穴穴┫┫树树稂稂树树树树
穴穴穴穴穴穴穴┫嶝嶝嶝道道道道道道道水水水嶝嶝嶝嶝┣穴穴穴穴穴穴┫┳┳┓稂稂稂稂稂稂
穴穴穴穴穴穴穴┫嶝嶝嶝嶝嶝嶝嶝嶝水圯水嶝飾飾飾飾嶝┗┐穴穴穴穴穴┫穴穴┫稂稂稂稂稂稂
穴穴穴穴穴穴穴┳┳┓嶝嶝嶝嶝水水水道嶝嶝飾飾飾飾嶝嶝┗┻┐穴穴穴┳┳┳┳┳┳┳┳┳┳
穴穴穴穴穴穴穴穴穴┫嶝嶝水水水嶝嶝道嶝嶝無無無無嶝嶝嶝嶝┗┐穴穴穴穴穴穴穴穴穴穴穴穴
穴穴穴穴穴穴穴┌┻┛水水水嶝嶝嶝嶝道嶝嶝無门買無嶝嶝嶝嶝嶝┗┻┻┐┌入┐穴穴穴穴穴穴
┻┐穴穴穴┌┻┛水水水飾飾飾飾道道道道道道道嶝嶝飾飾飾飾嶝嶝嶝嶝┗┛嶝┣穴穴穴穴穴穴
水┗┻┻┻┛水水水嶝嶝飾飾飾飾道飾飾飾飾嶝道嶝嶝無门無無道道嶝嶝嶝嶝嶝┣穴穴穴穴穴穴
水水水水水水水嶝嶝嶝嶝無無無無道飾飾飾飾嶝道嶝嶝嶝道道道道嶝嶝嶝嶝┏┳┳穴穴穴穴穴穴
┳┳┳┳┳┳┳┳┳┳┓無门学無道無無無無道道道道道道嶝嶝嶝嶝┏┳┳┳穴穴穴穴穴穴穴穴
穴穴穴穴穴穴穴穴穴穴┳┓道道道道無门館無道飾飾飾飾嶝嶝┏┳┳┳穴穴穴穴穴穴穴穴穴穴穴
穴穴穴穴穴穴穴穴穴穴穴┫嶝嶝嶝道道道道道道無门無無┏┳┳穴穴穴穴穴穴穴穴穴穴穴穴穴穴
穴穴穴穴穴穴穴穴穴穴穴┳┓嶝嶝嶝嶝嶝嶝嶝道道道嶝┏┳穴穴穴穴穴穴穴穴穴穴穴穴穴穴穴穴
穴穴穴穴穴穴穴穴穴穴穴穴┳┳┳┓嶝嶝嶝┏┳┳┳┳┳穴穴穴穴穴穴穴穴穴穴穴穴穴穴穴穴穴
穴穴穴穴穴穴穴穴穴穴穴穴穴穴穴┳┳┳┳┳穴穴穴穴穴穴穴穴穴穴穴穴穴穴穴穴穴穴穴穴穴穴
穴穴穴穴穴穴穴穴穴穴穴穴穴穴穴穴穴穴穴穴穴穴穴穴穴穴穴穴穴穴穴穴穴穴穴穴穴穴穴穴穴穴
穴穴穴穴穴穴穴穴穴穴穴穴穴穴穴穴穴穴穴穴穴穴穴穴穴穴穴穴穴穴穴穴穴穴穴穴穴穴穴穴穴穴
穴穴穴穴穴穴穴穴穴穴穴穴穴穴穴穴穴穴穴穴穴穴穴穴穴穴穴穴穴穴穴穴穴穴穴穴穴穴穴穴穴穴
穴穴穴穴穴穴穴穴穴穴穴穴穴穴穴穴穴穴穴穴穴穴穴穴穴穴穴穴穴穴穴穴穴穴穴穴穴穴穴穴穴穴
穴穴穴穴穴穴穴穴穴穴穴穴穴穴穴穴穴穴穴穴穴穴穴穴穴穴穴穴穴穴穴穴穴穴穴穴穴穴穴穴穴穴