树树树树树树树树树树树树树树树树树树树树树树树树树树道道树树水水树树树树树树树树树树树树树树树树树树树树树树树
树树树树树树树树树树树树树树树树树树树树树树树树树树道道树树水水水水水水水水水水水水水水水树树树树树树树树树树
树树畑畑畑社畑畑畑树树树树树树树树树树树树树树树树树道道树树水水水水水水水水水水水水水水水树树树树树树树树树树
树树畑畑畑畑畑畑畑树树树树树树树树树树树树树树树树树道道树树树树树树树树树树树树树树树水水树树树树树树树树树树
树树畑畑畑畑畑畑畑树树树树树树树树树树树树树树树树垣道道垣树树树树树树树树树树树树树树水水树树树树树树树树树树
树树畑畑畑畑畑畑畑树树树树树树树树树树树树树树树树垣道道垣树树树树树树树树树树树树树树水水树树树树树树树树树树
树树畑畑畑畑畑畑畑树树垣垣垣垣垣垣垣垣垣垣垣垣垣垣垣道道垣垣垣垣垣垣垣垣垣垣垣垣垣垣垣水水树树树树树树树树树树
树树土土土土土土土树树垣道道道道道道道道道道道道道垣道道垣道道道道土土土土土土土土土垣水水树树树树树树树树树树
树树土土土土土土土树树垣道道道道道道道道道道道道道道道道道飾飾飾飾土土树土水水水土土垣水水树树树树树树树树树树
树树土土飾飾飾飾树树树垣飾飾飾道道花土花土花土花土道道道道無门無無土水水水水华水土土垣水水树树树树树树树树树树
树树土土無门無無石树树垣無门無道道土飾飾飾飾飾飾花道道道道道道道道土水土土水水水水土垣水水树树树树树树树树树树
树树土土土土土土石树树垣道道道道道花飾飾飾飾飾飾土道道道道飾飾飾飾土水土土华土土水土垣水水树树树树树树树树树树
树树土土土土土土树树树垣飾飾飾道道土無無無無無無花道道道道無门無無土水水水水水土水土垣水水树树树树树树树树树树
树树树树树树土土树树树垣無门無道道花無门学無無無土道道道道道道道道土土土土水水华水土垣水水树树树树树树树树树树
树树树石石树土土树石石垣道道道道道土花土花土花土花道道道道飾道垣垣道垣垣土水水土水土垣水水树树树树树树树树树树
稂稂树石石树土土树石石垣飾飾飾飾道道道道道道道道道道道道道無道垣道道道垣土水土土水土垣水水土土土土树树树树树树
稂稂稂稂草草土土草草草垣飾飾飾飾道道飾飾飾飾道道飾道道道道無道垣道道道垣土土土土土土垣水水土土土土树树树树树树
稂稂稂稂稂草土土土草草垣無無無無道道飾飾飾飾道飾飾飾道道道無道垣道道道垣道道道道道道垣水水土土土土树树树树树树
草草稂稂稂草草土土土土垣無门無無道道無無無無道飾無飾道道無無無垣道道道垣道飾飾飾飾道垣水水土土土土树树树树树树
草道稂稂稂稂草草土垣垣垣垣道道道道道無门館無道無门無道道無门無垣垣道垣垣道無门無無垣垣水水土土土土树树树树树树
道道道道道道道道道道道道道道道道道道道道道道道道道道道道道道道道道道道道道道道道道道道橋橋土土土土土土土土土树
道道道道道道道道道道道道道道道道道道道道道道道道道道道道道道道道道道道道道道道道道道道橋橋土土土土土土土土土树
稂稂稂草草草草草草垣垣垣垣道飾飾飾飾飾飾道道飾飾飾飾道道道飾道土土土土土道飾飾飾飾垣垣水水树树树树树树树土土树
稂稂稂草草草草草草土土垣道道飾飾飾飾飾飾道道飾飾飾飾道道飾飾飾土水土水土道無门無無道垣水水树树树树树树树土土树
稂稂稂草树树树草草土土垣道道無無無無無無道道無無無無道道飾無飾土水水水土道道道道道道垣水水树树树树树树树土土树
树稂稂树树树树树草土土垣道道無無门競無無道道無無無無道道無無無土水水华土道道土土花土垣水水树树树树树树树土土树
树树树树树树树树树树树垣道道道道道道道道道道無無無無道道無飾無土水水水土道道花土土土垣水水树树树树树树树土土土
树树树树树树树树树树树垣道土土土土土土土道道無買買無道道飾飾飾土水水水土道道飾飾飾飾垣水水树树树树树树树土土土
树树树树树树树树树树树垣道土花土花土花土道道無门门無道道飾無飾土华水水土土道無门無無垣水水树树树树树树树树树树
树树树树树树树树树树树垣道土土花土花土土道道道道道道道道無無無土水水水树土道道道道道垣水水树树树树树树树树树树
树树树树树树树树树树树垣道土土土土土土土道飾飾飾飾道道道無门無土水水水土土土道道道道垣水水树树树树树树树树树树
土土土树树树树树树树树垣道土水水水水水土道飾飾飾飾道道道道道道土土土土土树土道道道道垣水水树树树树树树树树树树
土果土树树树树树树树树垣道土水华水水水土道無無無無道道道道道道道道道道土土土道道道道垣水水树树树树树树树树树树
土土土树树树树树树树树垣道土水水水华水土道無门無無道道道道道飾飾飾飾道道道道道道道道垣水水树树树树树树树树树树
土土土树树树树树树树树垣道土土土土土土土道道道道道道道道道道無门無無道道道道道道道道垣水水树树树树树树树树树树
树树树树树树树树树树树垣道道道道道道道道道道道道道垣道道垣道道道道道道道道道道道道道垣水水树树树树树树树树树树
树树树树树树树树树树树垣垣垣垣垣垣垣垣垣垣垣垣垣垣垣道道垣垣垣垣垣垣垣垣垣垣垣垣垣垣垣水水树树树树树树树树树树
树树树树树树树树树树水水水水水水水水水水水水水水水水圯圯水水水水水水水水水水水水水水水水水水水水水树树树树树树
树树树树树树树树树树水水水水水水水水水水水水水水水水圯圯水水水水水水水水水水水水水水水水水水水水水树树树树树树
树树树树树树树树树树水水树树树树树树树树树树树树树树土土树树树树树树树树树树树树树树树树树树树水水树树树树树树
树树树稂稂稂稂稂树树水水树树树树树树树树树树树树树树土土树树树树树树树树树树树树树树树树树树树水水树树树树树树
树树稂稂树稂树稂稂树水水树树树树树树土土土土土土土土土土树树树树树树树树树树树树树树树树树树树水水树树树树树树
稂稂稂树树稂稂稂稂稂水水树树树草草草土土土土土土土土土土树树树树树树树树树树树树树树树树树树树水水树树树树树树
稂树稂稂稂稂稂稂稂稂橋橋草草树草树树土土草草草草草草草草树树树树树树树树树树树树树树树树树树树水水树树树树树树
树稂稂稂稂稂稂稂稂稂水水树草树草树树土土草草草草草草草草树树树树树树树树树树树树树树树树树树树水水树树树树树树
稂稂稂稂稂稂稂稂稂树水水树草草草树树土土草草草草水水水水树树树树树树树树树树树树树树树树树树树水水树树树树树树
