海海海海海海海海海海海海無飾树树树飾飾飾土土水水水水水草草草飾飾飾飾飾飾树土土树土土树土土树土垣┣┣┣穴
海海海海海海海海海海海海無無树仏飾飾無飾飾土水水水水水草草草飾飾飾飾飾飾畑畑畑畑畑畑畑畑畑畑畑垣┣┣┣穴
海海海海海海海海海海海海海無無無飾無無無飾土土土土水水土土土無無無無無無土树土土树土土树土土树垣┣┣┗┻
海海海海海海海海海海海海海海海無無無门無無土土土土水水土土土無门無無门無畑畑畑畑畑畑畑畑畑畑畑垣┣┗┻┻
海海海海海海海海海海海海海海海海海無無無道道道道道橋橋道道道道道树树土土土土土土海海海海海海海海┗┻┻┐
海海海海海海海海海海海海海海海海海海海無無無道道道橋橋道道道道道树树土土土土土土海海海海海海海海海海石┣
海海海海海海海海海海海海海海海海海海海海海海無無無海海海海海海海海海海海海土树土海海树树树┏┳┳┳┳┳┳
海海海海海海海海海飾飾飾飾海海海海海海海海海海海無海無海海海海海海海海海海土土土海海树树树┣┏┳┳┳┳┳
海海海海海海海海海無门無無土海海海海海海海海海海海海海無树树树树树树树海海海海海海海树树树┣┣┏┳┳┳┳
海海海海海海海海海土土土土土土海海海海海海海海海海海海海無無树树树树树海海海海海海海树树树┣┣┣┏┳┳┳
海海海海海海海海海海土土土土土土土砂海海海海海海海海海海海海無無树树树树树树树树树树树树树┣┣┣┗入┻┻
海海海海海海海海海海土土土土土土土砂砂砂海海海海海海海海海海海海海無無树树树树树树树树树树┣┣┣穴穴穴穴
海海海海海海海海海海海土土土土树树树树砂砂砂海海海海海海海海海海海海海無無树树树树树树树树┣┣┗┻┻┻┻
海海海海海海海海海海海海土土土树树树树砂飾飾飾飾海海海海海海海海海海海海海無無树树树树树树┣┣穴┏┳┓穴
海海海海海海海海海海海海海土土树树树树砂無门無無砂砂海海海海海海海海海海海海海無無树树树树┣┣穴┗┐┫穴
海海海海海海海海海海海海海土土树树树树砂砂砂砂砂砂砂海海海海海海海海海海海海海海海無無無树┣┣穴穴┗┛穴
海海海海海海海海海海海海海土土树树树树土土土土土砂砂海海海海海海海海海海海海海海海海海海無無無┐穴穴穴穴
海海海海海海海海海海海海海土土树树树树草草草草土土砂砂海海海海海海海海海海海海海海海海海海海無無無岩穴無
海海海海海海海海海海海海垣垣土垣垣树树草草草草草草砂砂砂海海海海海海海海海海海海海海海海海海海海無無無無
海海海海海海海海海海海海垣道土道垣树树树树树树草草树砂砂海海海海海海海海海海海海海海海海海海海海海海無無
海海海海海海海海海海海海垣道道道垣树树树树树树草草树树砂砂海海海海海海海海海海海海海海海海海海海海海海海
海海海海海海海海海海海海垣道土道垣树树树树树草草草树树树树海海海海海海海海海海海海海海海海海海海海海海海
海海海海海海海海海海海海垣垣垣垣垣树草草草草草草草树树树树海海海海海海海海海海海海海海海海海海海海海海海
海海海海海海海海海海海海海树树树树树草树树树树树树树树树树海海海海海海海海海海海海海海海海海海海海海海海
海海海海海海海海海海海海海海砂砂树树草树树树树树树树树树树树树海海海海海海海海海海海海海海海海海海海海海
海海海海海海海海海海海海海海砂砂草草草树树树树树树树树树树树树树海海海海海海海海海海海海海海海海海海海海
海海海海海海海海海海海海海砂砂砂树树树树树树树树树树树树树树树树树树海海海海海海海海海海海海海海海海海海
海海海海海海海海海海海海海砂砂砂树树树树树树树树树树树树树树树树树树树树海海海海海海海海海海海海海海海海
海海海海海海海海海海海海海砂砂砂树树树树树稂树树树树树树树树树树树树树树海海海海海海海海海海海海海海海海
海海海海海海海海海海海海海砂砂砂树树树树稂稂树树树树树树树稂树树树树树树海海海海海海海海海海海海海海海海
海海海海海海海海海海海海海砂砂砂草草草草稂树树树树树树树树稂稂稂稂树树树海海海海海海海海海海海海海海海海
海海海海海海海海海海海海海砂砂砂树树树树树树砂砂砂砂砂砂树树树树稂树树树海海海海海海海海海海海海海海海海
海海海海海海海海海海海海海砂砂砂砂砂砂砂砂砂砂砂砂海海砂砂树树树草树树树树海海海海海海海海海海海海海海海
海海海海海海海海海海海海海海砂砂砂砂砂砂砂砂砂砂海海海海砂树树树草草树树树海海海海海海海海海海海海海海海
海海海海海海海海海海海海海海海海海海海海海海砂砂海海海海砂树树树树草草树树海海海海海海海海海海海海海海海
海海海海海海海海海海海海海海海海海海海海海海海海海海海海海海树树树树草树树海海海飾飾飾飾海海海海海海海海
海海海海海海海海海海海海海海海海海海海海海海海海海海海海海海海树树树草土土橋土土無门無無海海海海海海海海
海海海海海海海海海海海海海海海海海海海海海海海海海海海海海海海海树树树树海海树土土土土土橋橋海海海海海海
海海海海海海海海海海海海海海海海海海海海海海海海海海海海海海海海海海海海海海树草草草海海海海海海海海海海
海海海海海海海海海海海海海海海海海海飾飾飾飾砂砂海海海海海海海海海海海海海树树树草草海海海海海海海海海海
海海海海海海海海海海海海海海海海砂砂飾飾飾飾砂砂海海海海树树树树海海海海海草草草草草海海海海海海海海海海
海海海海海海海海海海海海海海海海砂砂無無無無砂砂海海海树草草草草树树海海海海草草草海海海海海海海海海海海
海海海海海海海海海海海海海海海海砂砂無無無無砂砂海海树树草海海草草树海海海海海海海海海海海海海海海海海海
海海海海海海海海海海海海海海海海砂砂無门無無砂砂海海树土海海海草草树海海海海海海海海海海海海海海海海海海
海海海海海海海海海海海海海海海海砂砂砂砂砂砂砂砂海海树土土海海草树海海海海海海海海海海海海海海海海海海海
海海海海海海海海海海海海海海海海海海砂砂砂砂砂砂海海树草草海草草树海海海海海海海海海海海海海海海海海海海
海海海海海海海海海海海海海海海海海海海海海海海海海海海海海海土土土土海海海海海海海海海海海海海海海海海海
