水水水水水水水水水水水水無飾树树树飾飾飾土土水水水水水草草草飾飾飾飾飾飾树土土树土土树土土树土垣┣┣┣穴
水水水水水水水水水水水水無無树仏飾飾無飾飾土水水水水水草草草飾飾飾飾飾飾畑畑畑畑畑畑畑畑畑畑畑垣┣┣┣穴
水水水水水水水水水水水水水無無無飾無無無飾土土土土水水土土土無無無無無無土树土土树土土树土土树垣┣┣┗┻
水水水水水水水水水水水水水水水無無無门無無土土土土水水土土土無门無無门無畑畑畑畑畑畑畑畑畑畑畑垣┣┗┻┻
水水水水水水水水水水水水水水水水水無無無道道道道道橋橋道道道道道树树土土土土土土水水水水水水水水┗┻┻┐
水水水水水水水水水水水水水水水水水水水無無無道道道橋橋道道道道道树树土土土土土土水水水水水水水水水水石┣
水水水水水水水水水水水水水水水水水水水水水水無無無水水水水水水水水水水水水土树土水水树树树┏┳┳┳┳┳┳
水水水水水水水水水飾飾飾飾水水水水水水水水水水水無水無水水水水水水水水水水土土土水水树树树┣┏┳┳┳┳┳
水水水水水水水水水無门無無土水水水水水水水水水水水水水無树树树树树树树水水水水水水水树树树┣┣┏┳┳┳┳
水水水水水水水水水土土土土土土水水水水水水水水水水水水水無無树树树树树水水水水水水水树树树┣┣┣┏┳┳┳
水水水水水水水水水水土土土土土土土砂水水水水水水水水水水水水無無树树树树树树树树树树树树树┣┣┣┗入┻┻
水水水水水水水水水水土土土土土土土砂砂砂水水水水水水水水水水水水水無無树树树树树树树树树树┣┣┣穴穴穴穴
水水水水水水水水水水水土土土土树树树树砂砂砂水水水水水水水水水水水水水無無树树树树树树树树┣┣┗┻┻┻┻
水水水水水水水水水水水水土土土树树树树砂飾飾飾飾水水水水水水水水水水水水水無無树树树树树树┣┣穴┏┳┓穴
水水水水水水水水水水水水水土土树树树树砂無门無無砂砂水水水水水水水水水水水水水無無树树树树┣┣穴┗┐┫穴
水水水水水水水水水水水水水土土树树树树砂砂砂砂砂砂砂水水水水水水水水水水水水水水水無無無树┣┣穴穴┗┛穴
水水水水水水水水水水水水水土土树树树树土土土土土砂砂水水水水水水水水水水水水水水水水水水無無無┐穴穴穴穴
水水水水水水水水水水水水水土土树树树树草草草草土土砂砂水水水水水水水水水水水水水水水水水水水無無無岩穴無
水水水水水水水水水水水水垣垣土垣垣树树草草草草草草砂砂砂水水水水水水水水水水水水水水水水水水水水無無無無
水水水水水水水水水水水水垣道土道垣树树树树树树草草树砂砂水水水水水水水水水水水水水水水水水水水水水水無無
水水水水水水水水水水水水垣道道道垣树树树树树树草草树树砂砂水水水水水水水水水水水水水水水水水水水水水水水
水水水水水水水水水水水水垣道土道垣树树树树树草草草树树树树水水水水水水水水水水水水水水水水水水水水水水水
水水水水水水水水水水水水垣垣垣垣垣树草草草草草草草树树树树水水水水水水水水水水水水水水水水水水水水水水水
水水水水水水水水水水水水水树树树树树草树树树树树树树树树树水水水水水水水水水水水水水水水水水水水水水水水
水水水水水水水水水水水水水水砂砂树树草树树树树树树树树树树树树水水水水水水水水水水水水水水水水水水水水水
水水水水水水水水水水水水水水砂砂草草草树树树树树树树树树树树树树水水水水水水水水水水水水水水水水水水水水
水水水水水水水水水水水水水砂砂砂树树树树树树树树树树树树树树树树树树水水水水水水水水水水水水水水水水水水
水水水水水水水水水水水水水砂砂砂树树树树树树树树树树树树树树树树树树树树水水水水水水水水水水水水水水水水
水水水水水水水水水水水水水砂砂砂树树树树树稂树树树树树树树树树树树树树树水水水水水水水水水水水水水水水水
水水水水水水水水水水水水水砂砂砂树树树树稂稂树树树树树树树稂树树树树树树水水水水水水水水水水水水水水水水
水水水水水水水水水水水水水砂砂砂草草草草稂树树树树树树树树稂稂稂稂树树树水水水水水水水水水水水水水水水水
水水水水水水水水水水水水水砂砂砂树树树树树树砂砂砂砂砂砂树树树树稂树树树水水水水水水水水水水水水水水水水
水水水水水水水水水水水水水砂砂砂砂砂砂砂砂砂砂砂砂水水砂砂树树树草树树树树水水水水水水水水水水水水水水水
水水水水水水水水水水水水水水砂砂砂砂砂砂砂砂砂砂水水水水砂树树树草草树树树水水水水水水水水水水水水水水水
水水水水水水水水水水水水水水水水水水水水水水砂砂水水水水砂树树树树草草树树水水水水水水水水水水水水水水水
水水水水水水水水水水水水水水水水水水水水水水水水水水水水水水树树树树草树树水水水飾飾飾飾水水水水水水水水
水水水水水水水水水水水水水水水水水水水水水水水水水水水水水水水树树树草土土橋土土無门無無水水水水水水水水
水水水水水水水水水水水水水水水水水水水水水水水水水水水水水水水水树树树树水水树土土土土土橋橋水水水水水水
水水水水水水水水水水水水水水水水水水水水水水水水水水水水水水水水水水水水水水树草草草水水水水水水水水水水
水水水水水水水水水水水水水水水水水水飾飾飾飾砂砂水水水水水水水水水水水水水树树树草草水水水水水水水水水水
水水水水水水水水水水水水水水水水砂砂飾飾飾飾砂砂水水水水树树树树水水水水水草草草草草水水水水水水水水水水
水水水水水水水水水水水水水水水水砂砂無無無無砂砂水水水树草草草草树树水水水水草草草水水水水水水水水水水水
水水水水水水水水水水水水水水水水砂砂無無無無砂砂水水树树草水水草草树水水水水水水水水水水水水水水水水水水
水水水水水水水水水水水水水水水水砂砂無门無無砂砂水水树土水水水草草树水水水水水水水水水水水水水水水水水水
水水水水水水水水水水水水水水水水砂砂砂砂砂砂砂砂水水树土土水水草树水水水水水水水水水水水水水水水水水水水
水水水水水水水水水水水水水水水水水水砂砂砂砂砂砂水水树草草水草草树水水水水水水水水水水水水水水水水水水水
水水水水水水水水水水水水水水水水水水水水水水水水水水水水水水土土土土水水水水水水水水水水水水水水水水水水
