水水水水水水水水水水水水砂砂飾飾飾飾砂砂水水水水树树树树水水水水水草草草草草水水水水水水水水水水水水水水水水水水水水水水水水水水水水
水水水水水水水水水水水水砂砂無無無無砂砂水水水树草草草草树树水水水水草草草水水水水水水水水水水水水水水水水水水水水水水水水水水水水水
水水水水水水水水水水水水砂砂無無無無砂砂水水树树草水水草草树水水水水水水水水水水水水水水水水水水水水水水水水水水水水水水水水水水水水
水水水水水水水水水水水水砂砂無门無無砂砂水水树土水水水草草树水水水水水水水水水水水水水水水水水水水水水水水水水水水水水水水水水水水水
水水水水水水水水水水水水砂砂砂砂砂砂砂砂水水树土土水水草树水水水水水水水水水水水水水水水水水水水水水水水水水水水水水水水水水水水水水
水水水水水水水水水水水水水水砂砂砂砂砂砂水水树草草水草草树水水水水水水水水水水水水水水水水水水水水水水水水水水水水水水水水水水水水水
水水水水水水水水水水水水水水水水水水水水水水水水水水土土土土水水水水水水水水水水水水水水水水水水水水水水水水水水水水水水水水水水水水
水水水水水水水水水水水水水水水水水水水水水水水水水水水水水水水水水水水水水水水水水水水水水水水水水水水水水水水水水水水水水水水水水水
水水水水水水水水水水水水水水水水水水水水水水水水水水水水水水水水水水水水水水水水水水水水水水水水水水水水水水水水水水水水水水水水水水
水水水水水水水水水水水水水水水水水水水水水水水水水水水水水水水水水水水水水水水水水水水水水水水水水水水水水水水水水水水水水水水水水水
水水水水水水水水水水水水水水水水水水水水水水水水水水水水水水水水水水水水水水水水水树草水水水水水水水水水水水水水水水水水水水水水水水
水水水水水水水水水水水水水水水水水水水水水水水水水水水水水水水水水水水水水水水水水树稂树草砂水水水水水水水水水水水水水水水水水水水水
水水水水水水水水水水水水水水水水水水水水水水水水水水水水水水水水水水水水水水水水稂草稂稂稂砂水水水水水水水水水水水水水水水水水水水水
水水水水水水水水水水水水水水水水水水水水水水水水水水水水水水水水水水水水水水水水水稂树草稂水水水水水水水水水水水水水水水水水水水水水
水水水水水水水水水水水水水水水水水水水水水水水水水水水水水水水水砂砂砂砂砂水水水水草树水圯稂水水水水水水水水水水水水水水水水水水水水
水水水水水水水水水水水水水水水水水水水水水水水水水水水水水水水砂砂砂砂砂砂砂砂砂水水树稂稂草水水水水水水水水水水水水水水水水水水水水
水水水水水水水水水水水水水水水水水水圯飾飾飾飾水水水水水水水砂砂┏┳┲┳┳┱┓穴水水稂草稂水水水水水水水水水水水水水水水水水水水水水
水水水水水水水水水水水水水水水水水水圯無门無無水水水水水水水砂砂┣穴═穴┌┛┫穴穴水稂水水水水水水水水水水水水水水水水水水水水水水水
水水水水水水水水水水水水水水水水水土土土土树树水水水水水树树树穴┣穴┣穴─穴─穴穴水水水水水水水水水水水水水水水水水水水水水水水水水
水水水水水水水水水水水水水水水水水土树树树树树水水水水水土土土穴═穴┗┻┛┌┛穴树水水水水水水水水水水水水水水水水水水水水水水水水水
水水水水水水水水水水水水水水水水水土树树土树土水水水水土土树土穴┗┻┻┐穴┫穴穴水水水水水水水水水水水水水水水水水水水水水水水水水水
水水水水水水水水水水水水水水水水水土土树土土土水水水水土土树树穴穴穴穴┣穴┫穴水水水水水水水水水水水水水水水水水水水水水水水水水水水
水水水水水水水水水水水水水水水水水水土树树土树水水水水水水水水水树树穴┗入┛穴水水水水水水水水水水水水水水水水水水水水水水水水水水水
水水水水水水水水水水水水水水水水水水土土土土树水水水水水水水水水水水穴穴穴穴穴水水水水水水水水水水水水水水水水水水水水水水水水水水水
水水水水水水水水水水水水水水水水水水水土土水水水水水水水水水水水水水水树树水水水水水水水水水水飾飾飾飾水水水水水水水水水水水水水水水
水水水水水水水水水水水水水水水水水水水水水水水水水水水水水水水水水水水水水水水水水水水水水水水飾飾飾飾水水水水水水水水水水水水水水水
水水水水水水水水水水水水水水水水水水水水水水水水水水水水水水水水水水水水水水水水水水水水水水砂無無無無水水水水水水水水水水水水水水水
水水水水水水水水水水水水水水水水水水水水水水水水水水水水水水水水水水水水水水水水水水水水水水砂無门無無水水水水水水水水水水水水水水水
水水水水水水水水水水水水水水水水水水水水水水水水水水水水水水水水水水水水水水水水水水水水水水砂砂砂砂砂砂橋橋水水水水水水水水水水水水
水水水水水水水水水水水水水水水水水水水水水水水水水水水水水水水水水水水水水水水垣垣垣垣垣水水树树砂砂砂水水水水水水水水水水水水水水水
水水水水水水水水水水水水水水水水水水水水水水水水水水水水水水水水水水水水水水水垣道砂道垣水水树树树树砂砂水水水水水水水水水水水水水水
水水水水水水水水水水水水水水水水水水水水水水水水水水水水水水水水水水水水水水水垣道道道垣水水树树树树砂砂砂水水水水水水水水水水水水水
水水水水水水水水水水水水水水水水水水水水水水水水水水水水水水水水水水水水水水水垣道砂道垣水土土無土土土土土水水水水水水水水水水水水水
水水水水水水水水水水水水水水水水水水水水水水水水水水水水水水水水水水水水水水水垣垣砂垣垣水树土土树树树树树树树水水水水水水水水水水水
水水水水水水水水水水水水水水水水水水水水水水水水水水水水水水水水水水水水水水水砂砂水水水水树土树树土土土树树土树树水水水水水水水水水
水水水水水水水水水水水水水水水水水水水水水水水水水水水水水水水水水水水水水橋橋砂砂水水水水树土树土無土土土土土砂砂砂水水水水水水水水
水水水水水水水水水水水水水水水水水水水水水水水水水水水水水水水水水水水水水水水水水水水砂土土土树土┏┲┳┳┳┳┱┓砂水水水水水水水水
水水水水水水水水水水水水水水水水水水水水水水水水水水水水水水水水水水水水水水水水水水砂砂树树树树土┣┣穴穴穴穴┫┫砂水水水水水水水水
水水水水水水水水水水水水水水水水水水水水水水水水水水水水水水水水水水水水水水水水水水砂树土土树土土┣┣穴穴穴穴┫┫無砂水水水水水水水
水水水水水水水水水水水水水水水水水水水水水水水水水水水水水水水水水水水水水水水水水水砂砂無土土無土┣┣穴水穴穴┫┫砂砂水水水水水水水
水水水水水水水水水水水水水水水水水水水水水水水水水水水水水水水水水水水水水水水水水水砂砂椰树树┏┳┳┗║滝┻║┛┫砂砂水水水水水水水
水水水水水水水水水水水水水水水水水水水水水水水水水水水水水水水水水水水水水水水水水水砂砂椰树树┣水水水穴水穴穴穴┫砂砂水水水水水水水
水水水水水水水水水水水水水水水水水水水水水水水水水水水水水水水水水水水水水水水水水水砂砂┏┳┳┳水穴水水水穴穴穴┫砂砂水水水水水水水
水水水水水水水水水水水水水水水水水水水水水水水水水水水水水水水水水水水水水水水水水水砂砂═穴穴水水穴┌┻┻║┻┻┛砂砂水水水水水水水
水水水水水水水水水水水水水水水水水水水水水水水水水水水水水水水水水水水水水水水水水水砂砂┣穴穴水穴穴┫树土土土砂砂砂水水水水水水水水
水水水水水水水水水水水水水水水水水水水水水水水水水水水水水水水水水水水水水水水水水水砂椰┣穴穴水水穴┫土土树树砂水水水水水水水水水水
水水水水水水水水水水水水水水水水水水水水水水水水水水水水水水水水水水水水水水水水水水水椰┗┻┐穴橋穴┫土土树树水水水水水水水水水水水
水水水水水水水水水水水水水水水水水水水水水水水水水水水水水水水水水水水水水水水水水水水砂土土═穴水穴┫树土土树树水水水水水水水水水水
水水水水水水水水水水水水水水水水水水水水水水水水水水水水水水水水水水水水水水水水水水水水土土┗┻滝║┛土土树树树树树树水水水水水水水
水水水水水水水水水水水水水水水水水水水水水水水水水水水水水水水水水水水水水水水水水水水水水土水水水土土土树树树树树砂砂水水水水水水水
水水水水水水水水水水水水水水水水水水水水水水水水水水水水水水水水水水水水水水水水水水水水水水水水土土土树树土树树砂砂砂水水水水水水水
水水水水水水水水水水水水水水水水水水水水水水水水水水水水水水水水水水水水水水水水水水水水水水水土土树树树土土土土砂砂砂水水水水水水水
水水水水水水水水水水水水水水水水水水水水水水水水水水水水水水水水水水水水水水水水水水水水水水砂土土树土土土树树砂砂椰砂水水水水水水水
水水水水水水水水水水水水水水水水水水水水水水水水水水水水水水水水水水水水水水水水水水水水水水砂树土土土土树树砂砂砂砂砂水水水水水水水
水水水水水水水水水水水水水水水水水水水水水水水水水水水水水水水水水水水水水水水水水水水水水水砂树树树树树树砂砂砂砂砂砂水水水水水水水
水水水水水水水水水水水水水水水水水水水水水水水水水水水水水水水水水水水水水水水水水水水水水水砂砂树树椰砂砂椰砂砂砂砂砂水水水水水水水
水水水水水水水水水水水水水水水水水水水水水水水水水水水水水水水水水水水水水水水水水水水水水水水砂砂砂砂砂砂砂椰砂砂砂水水水水水水水水
水水水水水水水水水水水水水水水水水水水水水水水水水水水水水水水水水水水水水水水水水水水水水水水水水水水水砂椰砂砂砂水水水水水水水水水
水水水水水水水水水水水水水水水水水水水水水水水水水水水水水水水水水水水水水水水水水水水水水水水水水水水水水水水水水水水水水水水水水水
水水水水水水水水水水水水水水水水水水水水水水水水水水水水水水水水水水水水水水水水水水水水水水水水水水水水水水水水水水水水水水水水水水
水水水水水水水水水水水水水水水水水水水水水水水水水水水水水水水水水水水水水水水水水水水水水水水水水水水水水水水水水水水水水水水水水水
水水水水水水水水水水水水水水水水水水水水水水水水水水水水水水水水水水水水水水水水水水水水水水水水水水水水水水水水水水水水水水水水水水
水水水水水水水水水水水水水水水水水水水水水水水水水水水水水水水水水水水水水水水水水水水水水水水水水水水水水水水水水水水水水水水水水水
水水水水水水水水水水水水水水水水水水水水水水水水水水水水水水水水水水水水水水水水水水水水水水水水水水水水水水水水水水水水水水水水水水
水水水水水水水水水水水水水水水水水水水水水水水水水水水水水水水水水水水水水水水水水水水水水水水水水水水水水水水水水水水水水水水水水水
