海海海海海海海海海海海海海砂砂海海海海砂树树树树草草树树海海海海
海海海海海海海海海海海海海海海海海海海海海树树树树草树树海海海飾
海海海海海海海海海海海海海海海海海海海海海海树树树草土土橋土土無
海海海海海海海海海海海海海海海海海海海海海海海树树树树海海树土土
海海海海海海海海海海海海海海海海海海海海海海海海海海海海海树草草
海海海海海海海海海飾飾飾飾砂砂海海海海海海海海海海海海海树树树草
海海海海海海海砂砂飾飾飾飾砂砂海海海海树树树树海海海海海草草草草
海海海海海海海砂砂無無無無砂砂海海海树草草草草树树海海海海草草草
海海海海海海海砂砂無無無無砂砂海海树树草海海草草树海海海海海海海
海海海海海海海砂砂無门無無砂砂海海树土海海海草草树海海海海海海海
海海海海海海海砂砂砂砂砂砂砂砂海海树土土海海草树海海海海海海海海
海海海海海海海海海砂砂砂砂砂砂海海树草草海草草树海海海海海海海海
海海海海海海海海海海海海海海海海海海海海海土土土土海海海海海海海
海海海海海海海海海海海海海海海海海海海海海海海海海海海海海海海海
海海海海海海海海海海海海海海海海海海海海海海海海海海海海海海海海
海海海海海海海海海海海海海海海海海海海海海海海海海海海海海海海海
海海海海海海海海海海海海海海海海海海海海海海海海海海海海海海海海
海海海海海海海海海海海海海海海海海海海海海海海海海海海海海海海海
海海海海海海海海海海海海海海海海海海海海海海海海海海海海海海海海
