水水水水水水水水水水水水水砂砂水水水水砂树树树树草草树树水水水水
水水水水水水水水水水水水水水水水水水水水水树树树树草树树水水水飾
水水水水水水水水水水水水水水水水水水水水水水树树树草土土橋土土無
水水水水水水水水水水水水水水水水水水水水水水水树树树树水水树土土
水水水水水水水水水水水水水水水水水水水水水水水水水水水水水树草草
水水水水水水水水水水水飾飾飾飾水水水水水水水水水水水水水树树树草
水水水水水水水水水水水無门無無水水水水水水水水水水水水水草草草草
水水水水水水水水水水土土土土水水水水水水水水水水水水水水水草草草
水水水水水水水橋橋土土土土树水水水水水飾飾飾飾水水水水水水水水水
水水水水水水水水水草草树树树水水水土土無门無無水水水水水水水水水
水水水水水水水水水草树树草草橋橋橋草土土土草草水水水水水水水水水
水水水水水水水水水草草草草草水水水草草草土草草水水水水水水水水水
水水水水水水水水水水水水水水水水水水水草土土土橋橋水水水水水水水
水水水水水水水水水水水水水水水水水水水水水水水水水水水水水水水水
水水水水水水水水水水水水水水水水水水水水水水水水水水水水水水水水
水水水水水水水水水水水水水水水水水水水水水水水水水水水水水水水水
水水水水水水水水水水水水水水水水水水水水水水水水水水水水水水水水
水水水水水水水水水水水水水水水水水水水水水水水水水水水水水水水水
水水水水水水水水水水水水水水水水水水水水水水水水水水水水水水水水
