水水水水水水水水水水水水水砂砂水水水水砂树树树树草草树树水水水水
水水水水水水水水水水水水水水水水水水水水水树树树树草树树水水水飾
水水水水水水水水水水水水水水水水水水水水水水树树树草土土橋土土無
水水水水水水水水水水水水水水水水水水水水水水水树树树树水水树土土
水水水水水水水水水水水水水水水水水水水水水水水水水水水水水树草草
水水水水水水水水水飾飾飾飾砂砂水水水水水水水水水水水水水树树树草
水水水水水水水砂砂飾飾飾飾砂砂水水水水树树树树水水水水水草草草草
水水水水水水水砂砂無無無無砂砂水水水树草草草草树树水水水水草草草
水水水水水水水砂砂無無無無砂砂水水树树草水水草草树水水水水水水水
水水水水水水水砂砂無门無無砂砂水水树土水水水草草树水水水水水水水
水水水水水水水砂砂砂砂砂砂砂砂水水树土土水水草树水水水水水水水水
水水水水水水水水水砂砂砂砂砂砂水水树草草水草草树水水水水水水水水
水水水水水水水水水水水水水水水水水水水水水土土土土水水水水水水水
水水水水水水水水水水水水水水水水水水水水水水水水水水水水水水水水
水水水水水水水水水水水水水水水水水水水水水水水水水水水水水水水水
水水水水水水水水水水水水水水水水水水水水水水水水水水水水水水水水
水水水水水水水水水水水水水水水水水水水水水水水水水水水水水水水水
水水水水水水水水水水水水水水水水水水水水水水水水水水水水水水水水
水水水水水水水水水水水水水水水水水水水水水水水水水水水水水水水水
