海海海海海海海海海海海海砂砂飾飾飾飾砂砂海海海海树树树树海海海海海草草草草草海海海海海海海海海海海海海海海海海海海海海海海海海海海海
海海海海海海海海海海海海砂砂無無無無砂砂海海海树草草草草树树海海海海草草草海海海海海海海海海海海海海海海海海海海海海海海海海海海海海
海海海海海海海海海海海海砂砂無無無無砂砂海海树树草海海草草树海海海海海海海海海海海海海海海海海海海海海海海海海海海海海海海海海海海海
海海海海海海海海海海海海砂砂無门無無砂砂海海树土海海海草草树海海海海海海海海海海海海海海海海海海海海海海海海海海海海海海海海海海海海
海海海海海海海海海海海海砂砂砂砂砂砂砂砂海海树土土海海草树海海海海海海海海海海海海海海海海海海海海海海海海海海海海海海海海海海海海海
海海海海海海海海海海海海海海砂砂砂砂砂砂海海树草草海草草树海海海海海海海海海海海海海海海海海海海海海海海海海海海海海海海海海海海海海
海海海海海海海海海海海海海海海海海海海海海海海海海海土土土土海海海海海海海海海海海海海海海海海海海海海海海海海海海海海海海海海海海海
海海海海海海海海海海海海海海海海海海海海海海海海海海海海海海海海海海海海海海海海海海海海海海海海海海海海海海海海海海海海海海海海海海
海海海海海海海海海海海海海海海海海海海海海海海海海海海海海海海海海海海海海海海海海海海海海海海海海海海海海海海海海海海海海海海海海海
海海海海海海海海海海海海海海海海海海海海海海海海海海海海海海海海海海海海海海海海海海海海海海海海海海海海海海海海海海海海海海海海海海
海海海海海海海海海海海海海海海海海海海海海海海海海海海海海海海海海海海海海海海海海椰砂低砂砂海海海海海海海海海海海海海海海海海海海海
海海海海海海海海海海海海海海海海海海海海海海海海海海海海海海海海海海海海海海海海海椰砂砂砂砂海海海海海海海海海海海海海海┏┳┲┳┳┱
海海海海海海海海海海海海海海海海海海海海海海海海海海海海海海海海海海海海海海海海砂砂椰砂砂海海海海海海海海海海海海海海海┣穴═穴┌┛
海海海海海海海海海海海海海海海海海海海海海海海海海海海海海海海海海海海海海海海海海砂砂砂椰海海海海海海海海海海海海海海海┣穴┣穴─穴
海海海海海海海海海海海海海海海海海海海海海海海海海海海海海海砂砂砂砂砂砂砂砂砂砂海海砂砂砂椰砂砂海海海海海海海海海海海海═穴┗┻┛┌
海海海海海海海海海海海海海海海海海海海海海海海海海海海海海海砂┌┻┻┻┻┻┻┻┐砂海椰砂砂砂砂海海海海海海海海海海海海海┗┻┻┐穴┫
海海海海海海海海海海海海海海海海海海土土土土土海海海海海海砂砂┫穴┌┻入┻┐穴┣砂海砂砂砂砂椰海海海海海海海海海海海海海穴穴穴┣穴┫
海海海海海海海海海海海海海海海海海海土土棋棋棋海海海海海海砂砂┫穴─穴穴穴┣穴═砂砂砂砂砂砂砂海海海海海海海海海海海海海树树穴┗入┛
海海海海海海海海海海海海海海海海海杉棋土土杉棋海海海海海砂砂砂─穴┫穴穴穴┣穴┣砂海海椰砂海海海海海海海海海海海海海海海海海海海海海
海海海海海海海海海海海海海海海海海棋棋土杉棋棋海海海海海砂砂砂┳┓┫穴穴穴┣穴┣砂海海海海海海海海海海海海海海海海海海海海海海海海海
海海海海海海海海海海海海海海海海杉棋土土棋棋土土土土土砂砂砂砂砂┫┳┳┓穴┣穴┣砂海海海海海海海海海海海海海海海海海海海海海海海海海
海海海海海海海海海海海海海海海海棋棋土棋土土土海海海海椰椰砂砂砂┫穴穴─穴┣穴┣海海海海海海海海海海海海海海海海海海海海海海海海海海
海海海海海海海海海海海海海海海海海棋土棋棋土棋海海海海海砂砂砂砂┫穴穴┳┳┳穴┣海海海海海海海海海海海海海海海海海海海海海海海海海海
海海海海海海海海海海海海海海海海海海土土土土棋海海海海海砂椰砂砂┳┳┳┳┳┳┳┳海海海海海海海海海海海海海海海海海海海海海海海海海海
海海海海海海海海海海海海海海海海海海海土土海海海海海海海海椰砂砂砂砂砂海海海海海海海海海海海海海海海海海海海海海海海海海海海海海海海
海海海海海海海海海海海海海海海海海海海海海海海海海海海海海砂砂砂海海海海海海海海海海海海海海海海海海海海海海海海海海海海海海海海海海
海海海海海海海海海海海海海海海海海海海海海海海海海海海海海海海海海海海海海海海海海海海海海海海海海海海海海海海海海海海海海海海海海海
海海海海海海海海海海海海海海海海海海海海海海海海海海海海海海海海海海海海海海海海海海海海海海海海海砂砂砂海海海海海海海海海海海海海海
海海海海海海海海海海海海海海海海海海海海海海海海海海海海海海海海海海海海海海海海海海海海海海海海砂砂砂砂海海海海海海海海海海海海海海
海海海海海海海海海海海海海海海海海海海海海海海海海海海海海海海海海海海海海海海海海海海海海海棋砂砂砂砂海海海海海海海海海海海海海海海
海海海海海海海海海海海海海海海海海海海海海海海海海海海海海海海海海海海海海海海海海海海海海海杉棋砂砂砂海海海海海海海海海海海海海海海
海海海海海海海海海海海海海海海海海海海海海海海海海海海海海海海海海海海海海海海海海海海海海海棋棋棋砂砂砂棋海海海海海海海海海海海海海
海海海海海海海海海海海海海海海海海海海海海海海海海海海海海海海海海海海海海海海海海海海海海海砂土土土土杉棋土土海海海海海海海海海海海
海海海海海海海海海海海海海海海海海海海海海海海海海海海海海海海海海海海海海海海海海海海海海海砂杉棋杉棋棋棋土泰土土海海海海海海海海海
海海海海海海海海海海海海海海海海海海海海海海海海海海海海海海海海海海海海海海海海海海海海海砂砂棋棋棋棋棋土土土土土海海海海海海海海海
海海海海海海海海海海海海海海海海海海海海海海海海海海海海海海海海海海海海海海海海海海海海海砂土棋土土土土土土土砂砂砂海海海海海海海海
海海海海海海海海海海海海海海海海海海海海海海海海海海海海海海海海海海海海海海海海海海海砂砂砂土棋土┏┲┲┳┳┱┱┓砂海海海海海海海海
海海海海海海海海海海海海海海海海海海海海海海海海海海海海海海海海海海海海海海海海海海砂砂杉棋杉棋土┣┣┣穴穴┫┫┫砂海海海海海海海海
海海海海海海海海海海海海海海海海海海海海海海海海海海海海海海海海海海海海海海海海海海砂棋棋棋棋棋土┣┣┗║║┛┫┫砂砂海海海海海海海
海海海海海海海海海海海海海海海海海海海海海海海海海海海海海海海海海海海海海海海海海海砂砂土土土土土┣┣穴穴穴穴┫┫砂砂海海海海海海海
海海海海海海海海海海海海海海海海海海海海海海海海海海海海海海海海海海海海海海海海海海砂砂椰杉棋┏┳┳┗║┻┻║┛┫砂砂海海海海海海海
海海海海海海海海海海海海海海海海海海海海海海海海海海海海海海海海海海海海海海海海海海砂砂椰棋棋┣水水水穴水水穴穴┫砂砂海海海海海海海
海海海海海海海海海海海海海海海海海海海海海海海海海海海海海海海海海海海海海海海海海海砂砂┏┳┳┳水穴水水水穴穴穴┫砂砂海海海海海海海
海海海海海海海海海海海海海海海海海海海海海海海海海海海海海海海海海海海海海海海海海海砂砂═穴穴水水穴┌┻┻║┻┻┛砂砂海海海海海海海
海海海海海海海海海海海海海海海海海海海海海海海海海海海海海海海海海海海海海海海海海海砂砂┣穴穴水穴穴┫棋土土土砂砂砂海海海海海海海海
海海海海海海海海海海海海海海海海海海海海海海海海海海海海海海海海海海海海海海海海海海砂椰┣穴穴水水穴┫土土杉棋砂海海海海海海海海海海
海海海海海海海海海海海海海海海海海海海海海海海海海海海海海海海海海海海海海海海海海海海椰┗┻┐穴橋穴┫土土棋棋海海海海海海海海海海海
海海海海海海海海海海海海海海海海海海海海海海海海海海海海海海海海海海海海海海海海海海海砂土土═穴水穴┫棋土杉棋棋海海海海海海海海海海
海海海海海海海海海海海海海海海海海海海海海海海海海海海海海海海海海海海海海海海海海海海海土土┗┻滝║┛土土棋棋棋棋棋棋海海海海海海海
海海海海海海海海海海海海海海海海海海海海海海海海海海海海海海海海海海海海海海海海海海海海海土海海海土土土棋棋杉棋棋砂砂海海海海海海海
海海海海海海海海海海海海海海海海海海海海海海海海海海海海海海海海海海海海海海海海海海海海海海海海土土土棋棋土棋棋砂砂砂海海海海海海海
海海海海海海海海海海海海海海海海海海海海海海海海海海海海海海海海海海海海海海海海海海海海海海海土土杉棋棋土土土土砂砂砂海海海海海海海
海海海海海海海海海海海海海海海海海海海海海海海海海海海海海海海海海海海海海海海海海海海海海海砂土土棋棋土土棋棋砂砂椰砂海海海海海海海
海海海海海海海海海海海海海海海海海海海海海海海海海海海海海海海海海海海海海海海海海海海海海海砂棋土土土土棋棋砂砂砂砂砂海海海海海海海
海海海海海海海海海海海海海海海海海海海海海海海海海海海海海海海海海海海海海海海海海海海海海海砂棋杉棋棋棋棋砂砂砂砂砂砂海海海海海海海
海海海海海海海海海海海海海海海海海海海海海海海海海海海海海海海海海海海海海海海海海海海海海海砂砂棋棋椰砂砂椰砂砂砂砂砂海海海海海海海
海海海海海海海海海海海海海海海海海海海海海海海海海海海海海海海海海海海海海海海海海海海海海海海砂砂砂砂砂砂砂椰砂砂砂海海海海海海海海
海海海海海海海海海海海海海海海海海海海海海海海海海海海海海海海海海海海海海海海海海海海海海海海海海海海海砂椰砂砂砂海海海海海海海海海
海海海海海海海海海海海海海海海海海海海海海海海海海海海海海海海海海海海海海海海海海海海海海海海海海海海海海海海海海海海海海海海海海海
海海海海海海海海海海海海海海海海海海海海海海海海海海海海海海海海海海海海海海海海海海海海海海海海海海海海海海海海海海海海海海海海海海
海海海海海海海海海海海海海海海海海海海海海海海海海海海海海海海海海海海海海海海海海海海海海海海海海海海海海海海海海海海海海海海海海海
海海海海海海海海海海海海海海海海海海海海海海海海海海海海海海海海海海海海海海海海海海海海海海海海海海海海海海海海海海海海海海海海海海
海海海海海海海海海海海海海海海海海海海海海海海海海海海海海海海海海海海海海海海海海海海海海海海海海海海海海海海海海海海海海海海海海海
海海海海海海海海海海海海海海海海海海海海海海海海海海海海海海海海海海海海海海海海海海海海海海海海海海海海海海海海海海海海海海海海海海
海海海海海海海海海海海海海海海海海海海海海海海海海海海海海海海海海海海海海海海海海海海海海海海海海海海海海海海海海海海海海海海海海海
