水水水水水水水水水水水水砂砂飾飾飾飾砂砂水水水水树树树树水水水水水草草草草草水水水水水水水水水水水水水水水水水水水水水水水水水水水水
水水水水水水水水水水水水砂砂無無無無砂砂水水水树草草草草树树水水水水草草草水水水水水水水水水水水水水水水水水水水水水水水水水水水水水
水水水水水水水水水水水水砂砂無無無無砂砂水水树树草水水草草树水水水水水水水水水水水水水水水水水水水水水水水水水水水水水水水水水水水水
水水水水水水水水水水水水砂砂無门無無砂砂水水树土水水水草草树水水水水水水水水水水水水水水水水水水水水水水水水水水水水水水水水水水水水
水水水水水水水水水水水水砂砂砂砂砂砂砂砂水水树土土水水草树水水水水水水水水水水水水水水水水水水水水水水水水水水水水水水水水水水水水水
水水水水水水水水水水水水水水砂砂砂砂砂砂水水树草草水草草树水水水水水水水水水水水水水水水水水水水水水水水水水水水水水水水水水水水水水
水水水水水水水水水水水水水水水水水水水水水水水水水水土土土土水水水水水水水水水水水水水水水水水水水水水水水水水水水水水水水水水水水水
水水水水水水水水水水水水水水水水水水水水水水水水水水水水水水水水水水水水水水水水水水水水水水水水水水水水水水水水水水水水水水水水水水
水水水水水水水水水水水水水水水水水水水水水水水水水水水水水水水水水水水水水水水水水水水水水水水水水水水水水水水水水水水水水水水水水水
水水水水水水水水水水水水水水水水水水水水水水水水水水水水水水水水水水水水水水水水水水水水水水水水水水水水水水水水水水水水水水水水水水
水水水水水水水水水水水水水水水水水水水水水水水水水水水水水水水水水水水水水水水水水树草水水水水水水水水水水水水水水水水水水水水水水水
水水水水水水水水水水水水水水水水水水水水水水水水水水水水水水水水水水水水水水水水水树稂树草砂水水水水水水水水水水水水水水水水水水水水
水水水水水水水水水水水水水水水水水水水水水水水水水水水水水水水水水水水水水水水水稂草稂稂稂砂水水水水水水水水水水水水水水水水水水水水
水水水水水水水水水水水水水水水水水水水水水水水水水水水水水水水水水水水水水水水水水稂树草稂水水水水水水水水水水水水水水水水水水水水水
水水水水水水水水水水水水水水水水水水水水水水水水水水水水水水水水砂砂砂砂砂水水水水草树水圯稂水水水水水水水水水水水水水水水水水水水水
水水水水水水水水水水水水水水水水水水水水水水水水水水水水水水水砂砂砂砂砂砂砂砂砂水水树稂稂草水水水水水水水水水水水水水水水水水水水水
水水水水水水水水水水水水水水水水水水圯飾飾飾飾水水水水水水水砂砂┏┳┲┳┳┱┓穴水水稂草稂水水水水水水水水水水水水水水水水水水水水水
水水水水水水水水水水水水水水水水水水圯無门無無水水水水水水水砂砂┣穴═穴┌┛┫穴穴水稂水水水水水水水水水水水水水水水水水水水水水水水
水水水水水水水水水水水水水水水水水土土土土树树水水水水水树树树穴┣穴┣穴─穴─穴穴水水水水水水水水水水水水水水水水水水水水水水水水水
水水水水水水水水水水水水水水水水水土树树树树树水水水水水土土土穴═穴┗┻┛┌┛穴树水水水水水水水水水水水水水水水水水水水水水水水水水
水水水水水水水水水水水水水水水水水土树树土树土水水水水土土树土穴┗┻┻┐穴┫穴穴水水水水水水水水水水水水水水水水水水水水水水水水水水
水水水水水水水水水水水水水水水水水土土树土土土水水水水土土树树穴穴穴穴┣穴┫穴水水水水水水水水水水水水水水水水水水水水水水水水水水水
水水水水水水水水水水水水水水水水水水土树树土树水水水水水水水水水树树穴┗入┛穴水水水水水水水水水水水水水水水水水水水水水水水水水水水
水水水水水水水水水水水水水水水水水水土土土土树水水水水水水水水水水水穴穴穴穴穴水水水水水水水水水水水水水水水水水水水水水水水水水水水
水水水水水水水水水水水水水水水水水水水土土水水水水水水水水水水水水水水树树水水水水水水水水水水水水水水水水水水水水水水水水水水水水水
水水水水水水水水水水水水水水水水水水水水水水水水水水水水水水水水水水水水水水水水水水水水水水水水水水水水水水水水水水水水水水水水水水
水水水水水水水水水水水水水水水水水水水水水水水水水水水水水水水水水水水水水水水水水水水水水水水砂泰砂砂水水水水水水水水水水水水水水水
水水水水水水水水水水水水水水水水水水水水水水水水水水水水水水水水水水水水水水水水水水水水水水水砂砂砂砂水水水水水水水水水水水水水水水
水水水水水水水水水水水水水水水水水水水水水水水水水水水水水水水水水水水水水水水水水水水水水水砂砂砂砂砂砂橋橋水水水水水水水水水水水水
水水水水水水水水水水水水水水水水水水水水水水水水水水水水水水水水水水水水水水水垣垣垣垣垣水水棋砂砂砂砂水水水水水水水水水水水水水水水
水水水水水水水水水水水水水水水水水水水水水水水水水水水水水水水水水水水水水水水垣道砂道垣水水杉棋砂砂砂砂水水水水水水水水水水水水水水
水水水水水水水水水水水水水水水水水水水水水水水水水水水水水水水水水水水水水水水垣道道道垣水水棋棋棋砂砂砂棋水水水水水水水水水水水水水
水水水水水水水水水水水水水水水水水水水水水水水水水水水水水水水水水水水水水水水垣道砂道垣水水砂土土土土杉棋土土水水水水水水水水水水水
水水水水水水水水水水水水水水水水水水水水水水水水水水水水水水水水水水水水水水水垣垣砂垣垣水水砂杉棋杉棋棋棋土泰土土水水水水水水水水水
水水水水水水水水水水水水水水水水水水水水水水水水水水水水水水水水水水水水水水水砂砂水水水水砂砂棋棋棋棋棋棋土土土土水水水水水水水水水
水水水水水水水水水水水水水水水水水水水水水水水水水水水水水水水水水水水水水橋橋砂砂水水水水砂土棋土土土土土土土砂砂砂水水水水水水水水
水水水水水水水水水水水水水水水水水水水水水水水水水水水水水水水水水水水水水水水水水水水砂砂砂土棋土┏┲┲┳┳┱┱┓砂水水水水水水水水
水水水水水水水水水水水水水水水水水水水水水水水水水水水水水水水水水水水水水水水水水水砂砂杉棋杉棋土┣┣┣穴穴┫┫┫砂水水水水水水水水
水水水水水水水水水水水水水水水水水水水水水水水水水水水水水水水水水水水水水水水水水水砂棋棋棋棋棋土┣┣┗║║┛┫┫砂砂水水水水水水水
水水水水水水水水水水水水水水水水水水水水水水水水水水水水水水水水水水水水水水水水水水砂砂土土土土土┣┣穴穴穴穴┫┫砂砂水水水水水水水
水水水水水水水水水水水水水水水水水水水水水水水水水水水水水水水水水水水水水水水水水水砂砂椰杉棋┏┳┳┗║┻┻║┛┫砂砂水水水水水水水
水水水水水水水水水水水水水水水水水水水水水水水水水水水水水水水水水水水水水水水水水水砂砂椰棋棋┣水水水穴水水穴穴┫砂砂水水水水水水水
水水水水水水水水水水水水水水水水水水水水水水水水水水水水水水水水水水水水水水水水水水砂砂┏┳┳┳水穴水水水穴穴穴┫砂砂水水水水水水水
水水水水水水水水水水水水水水水水水水水水水水水水水水水水水水水水水水水水水水水水水水砂砂═穴穴水水穴┌┻┻║┻┻┛砂砂水水水水水水水
水水水水水水水水水水水水水水水水水水水水水水水水水水水水水水水水水水水水水水水水水水砂砂┣穴穴水穴穴┫棋土土土砂砂砂水水水水水水水水
水水水水水水水水水水水水水水水水水水水水水水水水水水水水水水水水水水水水水水水水水水砂椰┣穴穴水水穴┫土土杉棋砂水水水水水水水水水水
水水水水水水水水水水水水水水水水水水水水水水水水水水水水水水水水水水水水水水水水水水水椰┗┻┐穴橋穴┫土土棋棋水水水水水水水水水水水
水水水水水水水水水水水水水水水水水水水水水水水水水水水水水水水水水水水水水水水水水水水砂土土═穴水穴┫棋土杉棋棋水水水水水水水水水水
水水水水水水水水水水水水水水水水水水水水水水水水水水水水水水水水水水水水水水水水水水水水土土┗┻滝║┛土土棋棋棋棋棋棋水水水水水水水
水水水水水水水水水水水水水水水水水水水水水水水水水水水水水水水水水水水水水水水水水水水水水土水水水土土土棋棋杉棋棋砂砂水水水水水水水
水水水水水水水水水水水水水水水水水水水水水水水水水水水水水水水水水水水水水水水水水水水水水水水水土土土棋棋土棋棋砂砂砂水水水水水水水
水水水水水水水水水水水水水水水水水水水水水水水水水水水水水水水水水水水水水水水水水水水水水水水土土杉棋棋土土土土砂砂砂水水水水水水水
水水水水水水水水水水水水水水水水水水水水水水水水水水水水水水水水水水水水水水水水水水水水水水砂土土棋棋土土棋棋砂砂椰砂水水水水水水水
水水水水水水水水水水水水水水水水水水水水水水水水水水水水水水水水水水水水水水水水水水水水水水砂棋土土土土棋棋砂砂砂砂砂水水水水水水水
水水水水水水水水水水水水水水水水水水水水水水水水水水水水水水水水水水水水水水水水水水水水水水砂棋杉棋棋棋棋砂砂砂砂砂砂水水水水水水水
水水水水水水水水水水水水水水水水水水水水水水水水水水水水水水水水水水水水水水水水水水水水水水砂砂棋棋椰砂砂椰砂砂砂砂砂水水水水水水水
水水水水水水水水水水水水水水水水水水水水水水水水水水水水水水水水水水水水水水水水水水水水水水水砂砂砂砂砂砂砂椰砂砂砂水水水水水水水水
水水水水水水水水水水水水水水水水水水水水水水水水水水水水水水水水水水水水水水水水水水水水水水水水水水水水砂椰砂砂砂水水水水水水水水水
水水水水水水水水水水水水水水水水水水水水水水水水水水水水水水水水水水水水水水水水水水水水水水水水水水水水水水水水水水水水水水水水水水
水水水水水水水水水水水水水水水水水水水水水水水水水水水水水水水水水水水水水水水水水水水水水水水水水水水水水水水水水水水水水水水水水水
水水水水水水水水水水水水水水水水水水水水水水水水水水水水水水水水水水水水水水水水水水水水水水水水水水水水水水水水水水水水水水水水水水
水水水水水水水水水水水水水水水水水水水水水水水水水水水水水水水水水水水水水水水水水水水水水水水水水水水水水水水水水水水水水水水水水水
水水水水水水水水水水水水水水水水水水水水水水水水水水水水水水水水水水水水水水水水水水水水水水水水水水水水水水水水水水水水水水水水水水
水水水水水水水水水水水水水水水水水水水水水水水水水水水水水水水水水水水水水水水水水水水水水水水水水水水水水水水水水水水水水水水水水水
水水水水水水水水水水水水水水水水水水水水水水水水水水水水水水水水水水水水水水水水水水水水水水水水水水水水水水水水水水水水水水水水水水
