水水水水水水水水水水水水水水水水树树树水水水水水水水水水水水水水水树树草草树水水水水水水水水水水水水水水水水水水水水水水水水水水水水
水水水水水水水水水水水水水水水树树树树水水水水水水水水水水水水水水水树草树水水水水水水水水水水水水水水水水水水水水水水水水水水水水水
水水水水水水水水水水水水水水树树树树树水水水水水水水水水水水水水水水水水水水水水水水水水水水水水水水水水水水水水水水水水水水水水水水
水水水水水水水水水水水水水水树树树树树水水水树树树树树水水水水水水水水水水水水水水水水水水水水水水水水水水水水水水水水水水水水水水水
水水水水水水水水水水水水水水树树树树树橋橋橋树树树树树树水水水水水水水水水水水水水水水水水水水水水水水水水水水水水水水水水水水水水水
水水水水水水水水水水水水水水树树树树树水水水树树树树树树水水水水水水水水水水水水水水水水水水水水水水水水水水水水水水水水水水水水水水
水水水水水水水水水水水水水水水水水水水水水水水水树树树树水水水水水水水水水水水水水水水水水水水水水水水水水水水水水水水水水水水水水水
水水水水水水水水水水水水水水水水水水水水水水水水水水水水水水水水水水水水水水水水水水水水水水水水水水水水水水水水水水水水水水水水水水
水水水水水水水水水水水水水水水水水水水水水水水水水水水水水水水水水水水水水水水水水水水水水水水水水水水水水水水水水水水水水水水水水水
水水水水水水水水水水水水水水水水水水水水水水水水水水水水水水水水水水水水水水水水水┏┲┱┓水水水水水水水水水水水水水水水水水水水水水
水水水水水水水水水水水水水水水水水水水水水水水水水水水水水水水水水水水水水水水水水┣┗┛┫水水水水水水水水水水水水水水水水水水水水水
水水水水水水水水水水水水水水水水水水水水水水水水水水水水水水水水水水水水水水水水水┗入┻┛砂水水水水水水水水水水水水水水水水水水水水
水水水水水水水水水水水水水水水水水水水水水水水水水水水水水水水水水水水水水水水水水穴穴土土砂水水水水水水水水水水水水水水水水水水水水
水水水水水水水水水水水水水水水水水水水水水水水水水水水水水水水水水水水水水水水水水土树稂稂水水水水水水水水水水水水水水水水水水水水水
水水水水水水水水水水水水水水水水水水水水水水水水水水水水水水水水水水水水水水水水水稂树水圯稂水水水水水水水水水水水水水水水水水水水水
水水水水水水水水水水水水水水水水水水水水水水水水水水水水水水水砂砂砂椰砂砂水水水水水树稂稂稂水水水水水水水水水水水水水水水水水水水水
水水水水水水水水水水水水水水水水水水水飾飾飾飾水水水水水水水砂砂┏┳┲┳┳┱┓穴水水稂稂稂水水水水水水水水水水水水水水水水水水水水水
水水水水水水水水水水水水水水水水水水树無门無無水水水水水水水砂砂┣穴═穴┌┛┫穴穴橋稂水水水水水水水水水水水水水水水水水水水水水水水
水水水水水水水水水水水水水水水水水土土土土树树水水水水水树树树穴┣穴┣穴─穴─穴穴水水水水水水水水水水水水水水水水水水水水水水水水水
水水水水水水水水水水水水水水水水水土树树树树树水水水水水土土土穴═穴┗┻┛┌┛穴树水水水水水水水水水水水水水水水水水水水水水水水水水
水水水水水水水水水水水水水水水水水土树树土树土橋橋橋橋土土树土穴┗┻┻┐穴┫穴穴水水水水水水水水水水水水水水水水水水水水水水水水水水
水水水水水水水水水水水水水水水水水土土树土土土水水水水土土树树穴穴穴穴┣穴┫水水水水水水水水水水水水水水水水水水水水水水水水水水水水
水水水水水水水水水水水水水水水水水水土树树土树水水水水水水水水水树树穴┗入┛水水水水水水水水水水水水水水水水水水水水水水水水水水水水
水水水水水水水水水水水水水水水水水水土土土土树水水水水水水水水水水水穴穴穴水水水水水水水水水水水水水水水水水水水水水水水水水水水水水
水水水水水水水水水水水水水水水水水水水土土水水水水水水水水水水水水水水树树水水水水水水水水水水水水水水水水水水水水水水水水水水水水水
水水水水水水水水水水水水水水水水水水水水水水水水水水水水水水水水水水水水水水水水水水水水水水水水水水水水水水水水水水水水水水水水水水
水水水水水水水水水水水水水水水水水水水水水水水水水水水水水水水水水水水水水水水水水水水水水水水水水水圯水水水水水水水水水水水水水水水
水水水水水水水水水水水水水水水水水水水水水水水水水水水水水水水水水水水水水水水水水水水水水水水水水水圯水水水水水水水水水水水水水水水
水水水水水水水水水水水水水水水水水水水水水水水水水水水水水水水水水水水水水水水水水水水水水水砂砂砂砂砂水水水水水水水水水水水水水水水
水水水水水水水水水水水水水水水水水水水水水水水水水水水水水水水水水水水水水水水┏┲┱┓水水水水砂砂砂砂水水水水水水水水水水水水水水水
水水水水水水水水水水水水水水水水水水水水水水水水水水水水水水水水水水水水水水水┣┗┛┫砂水水水砂砂椰砂砂水水水水水水水水水水水水水水
水水水水水水水水水水水水水水水水水水水水水水水水水水水水水水水水水水水水水水水┗┻入┛砂砂水水砂砂椰椰砂砂水水水水水水水水水水水水水
水水水水水水水水水水水水水水水水水水水水水水水水水水水水水水水水水水水水水水水水砂砂砂砂砂橋砂砂椰椰椰椰砂水水水水水水水水水水水水水
水水水水水水水水水水水水水水水水水水水水水水水水水水水水水水水水水水水水水水水水砂砂砂砂水水椰椰砂砂砂砂砂水水水水水水水水水水水水水
水水水水水水水水水水水水水水水水水水水水水水水水水水水水水水水水水水水水水水水水水水水水水砂砂砂砂飾飾飾飾椰水水水水水水水水水水水水
水水水水水水水水水水水水水水水水水水水水水水水水水水水水水水水水水水水水水水水水水水水水水砂椰椰椰無门無無砂砂砂水水水水水水水水水水
水水水水水水水水水水水水水水水水水水水水水水水水水水水水水水水水水水水水水水水水水水水水砂砂砂砂砂砂砂砂砂砂砂砂砂砂水水水水水水水水
水水水水水水水水水水水水水水水水水水水水水水水水水水水水水水水水水水水水水水水水水水水水砂砂树树树树树树树树椰砂砂砂水水水水水水水水
水水水水水水水水水水水水水水水水水水水水水水水水水水水水水水水水水水水水水水水水水水水砂砂砂树稂稂稂稂稂树树树椰砂砂砂水水水水水水水
水水水水水水水水水水水水水水水水水水水水水水水水水水水水水水水水水水水水水水水水水水水砂砂砂树稂树稂树稂稂稂稂树椰砂砂水水水水水水水
水水水水水水水水水水水水水水水水水水水水水水水水水水水水水水水水水水水水水水水水水水水椰椰树稂稂稂稂稂树稂树稂稂树砂砂水水水水水水水
水水水水水水水水水水水水水水水水水水水水水水水水水水水水水水水水水水水水水水水水水水水砂椰树稂树稂稂稂树树稂树稂树砂砂水水水水水水水
水水水水水水水水水水水水水水水水水水水水水水水水水水水水水水水水水水水水水水水水水水水砂砂树稂稂稂树稂稂稂树树稂树砂砂水水水水水水水
水水水水水水水水水水水水水水水水水水水水水水水水水水水水水水水水水水水水水水水水水水水砂砂椰树稂树稂稂稂稂稂树稂椰砂砂水水水水水水水
水水水水水水水水水水水水水水水水水水水水水水水水水水水水水水水水水水水水水水水水水水水砂砂砂飾飾飾飾树树稂树稂砂砂砂水水水水水水水水
水水水水水水水水水水水水水水水水水水水水水水水水水水水水水水水水水水水水水水水水水水水砂砂砂無门館無土土土稂树砂水水水水水水水水水水
水水水水水水水水水水水水水水水水水水水水水水水水水水水水水水水水水水水水水水水水水水水砂砂土土土土土土土树树树水水水水水水水水水水水
水水水水水水水水水水水水水水水水水水水水水水水水水水水水水水水水水水水水水水水水水水水水砂土树花树树树树土土砂水水水水水水水水水水水
水水水水水水水水水水水水水水水水水水水水水水水水水水水水水水水水水水水水水水水水水水水水砂土树树土土土土土树砂砂水水水水水水水水水水
水水水水水水水水水水水水水水水水水水水水水水水水水水水水水水水水水水水水水水水水水水水水水土土土土土土土土土土树水水水水水水水水水水
水水水水水水水水水水水水水水水水水水水水水水水水水水水水水水水水水水水水水水水水水水水水水水水┏┲┱┓树树土树树树水水水水水水水水水
水水水水水水水水水水水水水水水水水水水水水水水水水水水水水水水水水水水水水水水水水水水水水水水┣┗┛┫树土土土土土水水水水水水水水水
水水水水水水水水水水水水水水水水水水水水水水水水水水水水水水水水水水水水水水水水水水水水水水水┗┻入┛树树树树树土树水水水水水水水水
水水水水水水水水水水水水水水水水水水水水水水水水水水水水水水水水水水水水水水水水水水水水水水水水水土土土土树树土土土水水水水水水水水
水水水水水水水水水水水水水水水水水水水水水水水水水水水水水水水水水水水水水水水水水水水水水水水水水水水水李土土土土水水水水水水水水水
水水水水水水水水水水水水水水水水水水水水水水水水水水水水水水水水水水水水水水水水水水水水水水水水水水水水水树花土土水水水水水水水水水
水水水水水水水水水水水水水水水水水水水水水水水水水水水水水水水水水水水水水水水水水水水水水水水水水水水水水水土土水水水水水水水水水水
水水水水水水水水水水水水水水水水水水水水水水水水水水水水水水水水水水水水水水水水水水水水水水水水水水水水水水水水水水水水水水水水水水
水水水水水水水水水水水水水水水水水水水水水水水水水水水水水水水水水水水水水水水水水水水水水水水水水水水水水水水水水水水水水水水水水水
水水水水水水水水水水水水水水水水水水水水水水水水水水水水水水水水水水水水水水水水水水水水水水水水水水水水水水水水水水水水水水水水水水
水水水水水水水水水水水水水水水水水水水水水水水水水水水水水水水水水水水水水水水水水水水水水水水水水水水水水水水水水水水水水水水水水水
水水水水水水水水水水水水水水水水水水水水水水水水水水水水水水水水水水水水水水水水水水水水水水水水水水水水水水水水水水水水水水水水水水
水水水水水水水水水水水水水水水水水水水水水水水水水水水水水水水水水水水水水水水水水水水水水水水水水水水水水水水水水水水水水水水水水水
水水水水水水水水水水水水水水水水水水水水水水水水水水水水水水水水水水水水水水水水水水水水水水水水水水水水水水水水水水水水水水水水水水
水水水水水水水水水水水水水水水水水水水水水水水水水水水水水水水水水水水水水水水水水水水水水水水水水水水水水水水水水水水水水水水水水水
