水水橋橋土土土土树水水水水水飾飾飾飾水水水水水水水水水水水水水水水水水水水水水水水水水水水水
水水水水草草树树树水水水土土無门無無水水水水水水水水水水水水水水水水水水水水水水水水水水水水
水水水水草树树草草橋橋橋草土土土草草水水水水水水水水水水水水水水水水水水水水水水水水水水水水
水水水水草草草草草水水水草草草土草草水水水水水水水水水水水水水水水水水水水水水水水水水水水水
水水水水水水水水水水水水水水草土土土橋橋水水水水水水水水水水水水水水水水水水水水水水水水水水
水水水水水水水水水水水水水水水水水水水水水水水水水水水水水水水水水水水水水水水水水水水水水水
水水水水水水水水水水水水水水水水水水水水水水水水水水水水水水水水水水水水水水水水水水水水水水
水水水水水水水水水水水水水水水水水水水水水水水水水水水水水水水水水水水水水水水水水水水水水水
水水水水水水水水水水水水水水水水水水水水水水水水水水水水水水水树草水水水水水水水水水水水水水
水水水水水水水水水水水水水水水水水水水水水水水水水水水水水水水树稂树草砂橋橋水水水水水水水水
水水水水水水水水水水水水水水水水水水水水水水水水水水水水水水稂草稂稂稂砂水水水水水水水水水水
水水水水水水水水水水水水水水水水水水水水水水水水水水水水水水水稂树草稂水水水水水水水水水水水
水水水水水水水水水水水水水水水水水水水水水水砂砂砂砂砂水水水水草树水圯稂水水水水水水水水水水
水水水水水水水水水水水水水水水水水水水水水砂砂砂砂砂砂砂砂砂水水树稂稂草水水水水水水水水水水
水水水水水水水水圯飾飾飾飾水水水水水水水砂砂┏┳┲┳┳┱┓穴水水稂草稂水水水水水水水水水水水
水水水水水水水水圯無门無無水水水水水水水砂砂┣穴═穴┌┛┫穴穴橋稂水水水水水水水水水水水水水
水水水水水水水土土土土树树水水水水水树树树穴┣穴┣穴─穴─穴穴水水水水水水水水水水水水水水水
水水水水水水水土树树树树树水水水水水土土土穴═穴┗┻┛┌┛穴树水水水水水水水水水水水水水水水
水水水水水水水土树树土树土橋橋橋橋土土树土穴┗┻┻┐穴┫穴穴水水水水水水水水水水水水水水水水
水水水水水水水土土树土土土水水水水土土树树穴穴穴穴┣穴┫穴水水水水水水水水水水水水水水水水水
水水水水水水水水土树树土树水水水水水水水水水树树穴┗入┛穴水水水水水水水水水水水水水水水水水
水水水水水水水水土土土土树水水水水水水水水水水水穴穴穴穴穴水水水水水水水水水水水水水水水水水
水水水水水水水水水土土水水水水水水水水水水水水水水树树水水水水水水水水水水水水水水水水水水水
水水水水水水水水水水水水水水水水水水水水水水水水水水水水水水水水水水水水水水水水水水水水水水
水水水水水水水水水水水水水水水水水水水水水水水水水水水水水水水水水水水水水水水水水水水水水水
水水水水水水水水水水水水水水水水水水水水水水水水水水水水水水水水水水水水水水水水水水水水水水
水水水水水水水水水水水水水水水水水水水水水水水水水水水水水水水水水水水水水水砂砂砂砂橋橋水水
水水水水水水水水水水水水水水水水水水水水水水水水水水水水水垣垣垣垣垣水水水砂砂砂砂水水水水水
水水水水水水水水水水水水水水水水水水水水水水水水水水水水水垣道砂道垣水水水砂砂椰砂砂水水水水
水水水水水水水水水水水水水水水水水水水水水水水水水水水水水垣道道道垣水水水砂砂椰椰砂砂水水水
