水水砂砂無無無無砂砂水水树树草水水草草树水水水水水水水水水水水水水水水水水水水水水水水水水水
水水砂砂無门無無砂砂水水树土水水水草草树水水水水水水水水水水水水水水水水水水水水水水水水水水
水水砂砂砂砂砂砂砂砂水水树土土水水草树水水水水水水水水水水水水水水水水水水水水水水水水水水水
水水水水砂砂砂砂砂砂水水树草草水草草树水水水水水水水水水水水水水水水水水水水水水水水水水水水
水水水水水水水水水水水水水水水水土土土土水水水水水水水水水水水水水水水水水水水水水水水水水水
水水水水水水水水水水水水水水水水水水水水水水水水水水水水水水水水水水水水水水水水水水水水水水
水水水水水水水水水水水水水水水水水水水水水水水水水水水水水水水水飾飾飾飾水水水水水水水水水水
水水水水水水水水水水水水水水水水水水水水水水水水水水水水水水水水飾飾飾飾水水水水水水水水水水
水水水水水水水水水水水水水水水水水水水水水水水水水水水水水水水树無無無無水水水水水水水水水水
水水水水水水水水水水水水水水水水水水水水水水水水水水水水水水水树無無無無水水水水水水水水水水
水水水水水水水水水水水水水水水水水水水水水水水水水水水水水水稂草無门無無水水水水水水水水水水
水水水水水水水水水水水水水水水水水水水水水水水水水水水水水水水稂树草稂水水水水水水水水水水水
水水水水水水水水水水水水水水水水水水水水水水砂砂砂砂砂水水水水草树水圯稂水水水水水水水水水水
水水水水水水水水水水水水水水水水水水水水水砂砂砂砂砂砂砂砂砂水水树稂稂草水水水水水水水水水水
水水水水水水水水圯飾飾飾飾水水水水水水水砂砂┏┳┲┳┳┱┓穴水水稂草稂水水水水水水水水水水水
水水水水水水水水圯無门無無水水水水水水水砂砂┣穴═穴┌┛┫穴穴水稂水水水水水水水水水水水水水
水水水水水水水土土土土树树水水水水水树树树穴┣穴┣穴─穴─穴穴水水水水水水水水水水水水水水水
水水水水水水水土树树树树树水水水水水土土土穴═穴┗┻┛┌┛穴树水水水水水水水水水水水水水水水
水水水水水水水土树树土树土水水水水土土树土穴┗┻┻┐穴┫穴穴水水水水水水水水水水水水水水水水
水水水水水水水土土树土土土水水水水土土树树穴穴穴穴┣穴┫穴水水水水水水水水水水水水水水水水水
水水水水水水水水土树树土树水水水水水水水水水树树穴┗入┛穴水水水水水水水水水水水水水水水水水
水水水水水水水水土土土土树水水水水水水水水水水水穴穴穴穴穴水水水水水水水水水水水水水水水水水
水水水水水水水水水土土水水水水水水水水水水水水水水树树水水水水水水水水水水水水水水水水水水水
水水水水水水水水水水水水水水水水水水水水水水水水水水水水水水水水水水水水水水水水水水水水水水
水水水水水水水水水水水水水水水水水水水水水水水水水水水水水水水水水水水水水水水水水水水水水水
水水水水水水水水水水水水水水水水水水水水水水水水水水水水水水水水水水水水水水水砂砂砂水水水水
水水水水水水水水水水水水水水水水水水水水水水水水水水水水水水水水水水水水水水砂砂砂砂水水水水
水水水水水水水水水水水水水水水水水水水水水水水水水水水水水水水水水水水水棋砂砂砂砂水水水水水
水水水水水水水水水水水水水水水水水水水水水水水水水水水水水水水水水水水水杉棋砂砂砂水水水水水
水水水水水水水水水水水水水水水水水水水水水水水水水水水水水水水水水水水水棋棋棋砂砂砂棋水水水
