海海砂砂無無無無砂砂海海树树草海海草草树海海海海海海海海海海海海海海海海海海海海海海海海海海
海海砂砂無门無無砂砂海海树土海海海草草树海海海海海海海海海海海海海海海海海海海海海海海海海海
海海砂砂砂砂砂砂砂砂海海树土土海海草树海海海海海海海海海海海海海海海海海海海海海海海海海海海
海海海海砂砂砂砂砂砂海海树草草海草草树海海海海海海海海海海海海海海海海海海海海海海海海海海海
海海海海海海海海海海海海海海海海土土土土海海海海海海海海海海海海海海海海海海海海海海海海海海
海海海海海海海海海海海海海海海海海海海海海海海海海海海海海海海海海海海海海海海海海海海海海海
海海海海海海海海海海海海海海海海海海海海海海海海海海海海海海海海海海海海海海海海海海海海海海
海海海海海海海海海海海海海海海海海海海海海海海海海海海海海海海海海海海海海海海海海海海海海海
海海海海海海海海海海海海海海海海海海海海海海海海海海海海海海海椰砂低砂砂海海海海海海海海海海
海海海海海海海海海海海海海海海海海海海海海海海海海海海海海海海椰砂砂砂砂海海海海海海海海海海
海海海海海海海海海海海海海海海海海海海海海海海海海海海海海海砂砂椰砂砂海海海海海海海海海海海
海海海海海海海海海海海海海海海海海海海海海海海海海海海海海海海砂砂砂椰海海海海海海海海海海海
海海海海海海海海海海海海海海海海海海海海砂砂砂砂砂砂砂砂砂砂海海砂砂砂椰砂砂海海海海海海海海
海海海海海海海海海海海海海海海海海海海海砂┌┻┻┻┻┻┻┻┐砂海椰砂砂砂砂海海海海海海海海海
海海海海海海海海土土土土土海海海海海海砂砂┫穴┌┻入┻┐穴┣砂海砂砂砂砂椰海海海海海海海海海
海海海海海海海海土土棋棋棋海海海海海海砂砂┫穴─穴穴穴┣穴═砂砂砂砂砂砂砂海海海海海海海海海
海海海海海海海杉棋土土杉棋海海海海海砂砂砂─穴┫穴穴穴┣穴┣砂海海椰砂海海海海海海海海海海海
海海海海海海海棋棋土杉棋棋海海海海海砂砂砂┳┓┫穴穴穴┣穴┣砂海海海海海海海海海海海海海海海
海海海海海海杉棋土土棋棋土土土土土砂砂砂砂砂┫┳┳┓穴┣穴┣砂海海海海海海海海海海海海海海海
海海海海海海棋棋土棋土土土海海海海椰椰砂砂砂┫穴穴─穴┣穴┣海海海海海海海海海海海海海海海海
海海海海海海海棋土棋棋土棋海海海海海砂砂砂砂┫穴穴┳┳┳穴┣海海海海海海海海海海海海海海海海
海海海海海海海海土土土土棋海海海海海砂椰砂砂┳┳┳┳┳┳┳┳海海海海海海海海海海海海海海海海
海海海海海海海海海土土海海海海海海海海椰砂砂砂砂砂海海海海海海海海海海海海海海海海海海海海海
海海海海海海海海海海海海海海海海海海海砂砂砂海海海海海海海海海海海海海海海海海海海海海海海海
海海海海海海海海海海海海海海海海海海海海海海海海海海海海海海海海海海海海海海海海海海海海海海
海海海海海海海海海海海海海海海海海海海海海海海海海海海海海海海海海海海海海海海砂砂砂海海海海
海海海海海海海海海海海海海海海海海海海海海海海海海海海海海海海海海海海海海海砂砂砂砂海海海海
海海海海海海海海海海海海海海海海海海海海海海海海海海海海海海海海海海海海棋砂砂砂砂海海海海海
海海海海海海海海海海海海海海海海海海海海海海海海海海海海海海海海海海海海杉棋砂砂砂海海海海海
海海海海海海海海海海海海海海海海海海海海海海海海海海海海海海海海海海海海棋棋棋砂砂砂棋海海海
