水水水水土土土土树水水水水水飾飾飾飾水水水水水水水水水水水水水水水水水水水水水水水水水水
水水水水草草树树树水水水土土無门無無水水水水水水水水水水水水水水水水水水水水水水水水水水
水水水水草树树草草橋橋橋草土土土土土水水水水水水水水水水水水水水水水水水水水水水水水水水
水水水水草草草草草水水水草草草草土土水水水水水水水水水水水水水水水水水水水水水水水水水水
水水水水水水水水水水水水水水草草草草水水水水水水水水水水水水水水水水水水水水水水水水水水
水水水水水水水水水水水水水水水水水水水水水水水水水水水水水水水水水水水水水水水水水水水水
水水水水水水水水水水水水水水水水水水水水水水水水水水水水水水水水水水水水水水水水水水水水
水水水水水水水水水水水水水水水水水水水水水水水水水水水水水水水水水水水水水水水水水水水水
水水水水水水水水水水水水水水水水水水水水水水水水水水水水水水水飾飾飾飾水水水水水水水水水
水水水水水水水水水水水水水水水水水水水水水水水水水水水水水水水無入無無砂水水水水水水水水
水水水水水水水水水水水水水水水水水水水水水水水水水水水水水水水土土土土砂水水水水水水水水
水水水水水水水水水水水水水水水水水水水水水水水水水水水水水水水土树稂稂水水水水水水水水水
水水水水水水水水水水水水水水水水水水水水水水水水水水水水水水水稂树水圯稂水水水水水水水水
水水水水水水水水水水水水水水水水水水水水水砂砂砂椰砂砂水水水水水树稂稂稂水水水水水水水水
水水水水水水水水水飾飾飾飾水水水水水水水砂砂┏┳┲┳┳┱┓穴水水稂稂稂水水水水水水水水水
水水水水水水水水树無门無無水水水水水水水砂砂┣穴═穴┌┛┫穴穴橋稂水水水水水水水水水水水
水水水水水水水土土土土树树水水水水水树树树穴┣穴┣穴─穴─穴穴水水水水水水水水水水水水水
水水水水水水水土树树树树树水水水水水土土土穴═穴┗┻┛┌┛穴树水水水水水水水水水水水水水
水水水水水水水土树树土树土橋橋橋橋土土树土穴┗┻┻┐穴┫穴穴水水水水水水水水水水水水水水
水水水水水水水土土树土土土水水水水土土树树穴穴穴穴┣穴┫水水水水水水水水水水水水水水水水
水水水水水水水水土树树土树水水水水水水水水水树树穴┗入┛水水水水水水水水水水水水水水水水
水水水水水水水水土土土土树水水水水水水水水水水水穴穴穴水水水水水水水水水水水水水水水水水
水水水水水水水水水土土水水水水水水水水水水水水水水树树水水水水水水水水水水水水水水水水水
水水水水水水水水水水水水水水水水水水水水水水水水水水水水水水水水水水水水水水水水水水水水
水水水水水水水水水水水水水水水水水水水水水水水水水水水水水水水水水水水水水水水水水水水水
水水水水水水水水水水水水水水水水水水水水水水水水水水水水水水水水水水水水水水水水水水水水
水水水水水水水水水水水水水水水水水水水水水水水水水水水水水水水水水水水水砂砂砂砂砂水水水
水水水水水水水水水水水水水水水水水水水水水水水水水水水水水水水水水水水水水砂砂砂砂水水水
水水水水水水水水水水水水水水水水水水水水水水水水水水水水水水飾飾飾飾水水水砂砂椰砂砂水水
水水水水水水水水水水水水水水水水水水水水水水水水水水水水水水無入無無砂水水砂砂椰椰砂砂水
