海海砂砂無無無無砂砂海海树树草海海草草树海海海海海海海海海海海海海海海海海海海海海海海海海海
海海砂砂無门無無砂砂海海树土海海海草草树海海海海海海海海海海海海海海海海海海海海海海海海海海
海海砂砂砂砂砂砂砂砂海海树土土海海草树海海海海海海海海海海海海海海海海海海海海海海海海海海海
海海海海砂砂砂砂砂砂海海树草草海草草树海海海海海海海海海海海海海海海海海海海海海海海海海海海
海海海海海海海海海海海海海海海海土土土土海海海海海海海海海海海海海海海海海海海海海海海海海海
海海海海海海海海海海海海海海海海海海海海海海海海海海海海海海海海海海海海海海海海海海海海海海
海海海海海海海海海海海海海海海海海海海海海海海海海海海海海海海海砂砂砂砂海海海海海海海海海海
海海海海海海海海海海海海海海海海海海海海海海海海海海海海海海海海砂泰砂砂海海海海海海海海海海
海海海海海海海海海海海海海海海海海海海海海海海海海海海海海海海椰砂砂砂砂海海海海海海海海海海
海海海海海海海海海海海海海海海海海海海海海海海海海海海海海海海椰砂砂砂砂海海海海海海海海海海
海海海海海海海海海海海海海海海海海海海海海海海海海海海海海海砂砂椰砂砂海海海海海海海海海海海
海海海海海海海海海海海海海海海海海海海海海海海海海海海海海海海砂砂砂椰海海海海海海海海海海海
海海海海海海海海海海海海海海海海海海海海砂砂無砂砂無無砂砂砂海海砂砂砂椰砂砂海海海海海海海海
海海海海海海海海海海海海海海海海海海海海砂┌┻┻┻┻┻┻┻┐砂海椰砂砂砂砂海海海海海海海海海
海海海海海海海海無土社社無海海海海海海砂社┫穴┌┻入┻┐穴┣砂海砂砂砂砂椰海海海海海海海海海
海海海海海海海海土土棋棋棋海海海海海海無砂┫穴─穴社穴┣穴═砂砂砂砂砂砂砂海海海海海海海海海
海海海海海海海杉棋土土杉棋海海海海海砂砂砂─穴┫穴穴穴┣穴┣砂海海椰砂海海海海海海海海海海海
海海海海海海海棋棋土杉棋棋海海海海海砂砂砂┳┓┫穴穴穴┣社┣砂海海海海海海海海海海海海海海海
海海海海海海杉棋土土棋棋社土土土土砂砂砂砂砂┫┳┳┓穴┣穴┣砂海海海海海海海海海海海海海海海
海海海海海海棋棋土树土土土海海海海椰椰砂砂砂┫穴穴─社┣穴┣砂海海海海海海海海海海海海海海海
海海海海海海海棋土树树土树海海海海海砂社砂砂┫穴穴┳┳┳穴┣砂海海海海海海海海海海海海海海海
海海海海海海海海土土社無树海海海海海無椰砂砂┳┳┳┳┳┳┳┳砂海海海海海海海海海海海海海海海
海海海海海海海海海土無海海海海海海海海椰砂砂砂砂社砂無砂砂砂海海海海海海海海海海海海海海海海
海海海海海海海海海海海海海海海海海海海砂砂砂砂砂砂海海海海海海海海海海海海海海海海海海海海海
海海海海海海海海海海海海海海海海海海海海海海海海海海海海海海海海海海海海海海海海海海海海海海
海海海海海海海海海海海海海海海海海海海海海海海海海海海海海海海海海海海海海海海砂砂砂海海海海
海海海海海海海海海海海海海海海海海海海海海海海海海海海海海海海海海海海海海海砂砂砂砂海海海海
海海海海海海海海海海海海海海海海海海海海海海海海海海海海海海海海海海海海棋砂砂砂砂海海海海海
海海海海海海海海海海海海海海海海海海海海海海海海海海海海海海海海海海海海杉棋砂砂砂海海海海海
海海海海海海海海海海海海海海海海海海海海海海海海海海海海海海海海海海海海棋棋棋砂砂砂棋海海海
