树树树树树树树树树树树树树树树树树树树树树树树树树树树树树树树树树树树树树树树树树树树树树树树水水水
树树树树树树树树树树树树树树树树树树树树树树树树树树树树树树树树树树树树树树树树树树树树树树树水水树
树树树树树树树树树树树树树树树树树稂稂草草土树土土草草草草土土土树土草草树树树树树树树树树树树水水树
树树树树树树树树树树树树树树树树树稂树树树土树土树树树树树树树土土土树草草草树树树树树树树水水水水树
树树树树树树树树树树树树树树树树树草草土树土树土树土草草土土树土树树树树树草树树树树树树树水水水水树
树树树树树树树树树树树树树树树树树树树土树土树土树土树树树土树土土树草草草草树树树树水水水水水树树树
树树树树树树树树树树树树树树树树树草土土树土土土土土树土土土树树土树草树树树树树树树水水水水水树树树
树树树树树树树树树树树树树树树树树土树树树草树树树树树草树土土土土树草草草草树树树树水水树树树树石石
树树树树树树树树树树树树树树树树树土土土草草草草树土草草树树树树土树树树树草树树树树水水树树树树石石
树树树树树树树树树树树树树树树树树树土树树草树草树土树草草土土树土土土土道道道道道道橋橋道道道道草草
树树树树树树树树树树树树树树树树树树土树土土树土树树树草树树土树土土土土道道道道道道橋橋道道道道草草
树树树树树树树树树树树树树树树树树树土土土树树土土土土土树土土树土树草树树树树树树树水水草草草草草草
树树树树树树树飾飾飾飾土土土土土树树土树土土树土树土树树树树树树土树草树草草草树树树水水草草草草草草
树树树树树树树無门無無土土土土土树树土树树土树土树土树土土土土土土树草草草树草水水水水水草草草草土土
树树树树树树树道道道道道道道道道道道土树土土土土树土树土树草树树树树树树树树草水水水水水草草草草土土
草草草草草树树道道道道道道道道道道道土树土树土树树土树草树草草土土土草草草草草水树树树树草草草草土土
水水草草草树树土土树树土土土土土道道树树土树树树草草树草树树树土树树树树树草水水树树树树草草草草土土
水树草水草土土土土树树土土土土土道道树树土土土树树草草草树草土土树土土草树草水水树树树树树树树树树树
草草草水草土土土土树树土土土土土道道树树树树土土树树树草树草树树树土树草树草水水树树树树树树树树树树
水草草草草土土树树树树稂树树树树道道树树树树树土土土土土土土土土土土树草草草水水树树树树树树树树树树
草草草草草土土树树稂稂稂树树树树道道树树飾飾飾飾树树树树树树树水水水水水水水水水树树树树树树树树树树
草草水水草土土树树稂水水树树树树道道树树無门買無树树树树树树树水水水水水水水水水树树树树树树树树树树
草草草草草土土树树稂稂稂稂稂稂树道道道道道道道土草草草草树树树水水树树树树树树树树树树树树树树树树树
土土土土土土土草树树水稂水水稂树道道道道道道道土草草草草水水水水水树树树树树树树树树树树树树树树树树
土土土土土土土草草树稂稂水稂稂树草草草草土道道土草草草草水水水水水树树树树树树树树石石石石树树树树树
树树树草草草草草草树水水水稂水树草草草草土道道土草草草草水水树树树树树树树树树石石石石石石石树树树树
草稂树草草草草草草树树树树稂水水稂稂草草土土土土土土土土水水树树树树树树树树石石石石石石石石石树树树
草草树树稂草树树草树稂树树稂稂稂稂稂草草土土土土土土土土水水树树树树树树树石石石石石石石石石石石石树
稂草树稂稂草树草草草草树树树树树稂稂草草草草草草土土稂稂水水树树树树树树石石石石石石石石石石石石石石
树草草草草草树树树树树树树树树树稂稂草草草草草草土土稂稂水水树树树树树树石石石石石石石石石石石石石石
树树树树树树树树树树树树树树树树树树稂稂稂稂稂稂土土草草水水树树树树树石石石石石石石石石石石石石石石
树树树树树树树树树树树树树树树树树树稂稂稂稂稂稂土土草草水水树树树树树石石石石石石石石石石石石石石石
树树树树树树树树树树树树树树树树树树土土土土稂稂草草草草水水树树树树树石石石石石石石石石石石石石石石
树树树树树树树树树树树树树树树树树树土土土土稂稂草草草草水水树树树树树石石石石石石石石石石石石石石石
树树树树树树树树树树树树树树树树树树稂稂稂稂稂稂草草土土水水树树树树树树石石石石石石石石石石石石石石
树树树树树树树树树树树树树树树树树树稂稂稂稂稂稂草草土土水水树树树树树树树石石石树树树树树树树树树树
树树树树树树树树树树树树树树树树树树草草草草草草土土土土水水树树树树树树树石石石树树水水水水水水水水
树树树树树树树树树树树树树树树树树树草草草草草草土土土土水水树树树树树树树树树树树树水水水水水水水飾
树树树树树树树树树树树树树树树树树树稂稂土土草草草草稂稂水水树树树树树树树树树树树树水水畑畑畑畑飾飾
树树树树树树树树树树树树树树树树树树稂稂土土草草草草稂稂水水树树树树树树树树树树树树水水畑畑畑畑無無
树树树树树树树树树树树树树树树树树树稂稂土土土土土土稂稂水水水水水水水水水水水水水水水水畑畑畑畑花李
树树树树树树树树树树树树树树树树树树稂稂土土土土土土稂稂水水水水水水水水水水水水水水水飾飾飾飾土土土
树水水水水水水水水水水水水水水水水水水水水橋橋水水水水水水水树树树树树草草草草草草草草無门無無土飾飾
树水水水水水水水水水水水水水水水水水水水水橋橋水水水水水水水树树草草草草树树树树树树草草土土土土飾飾
树水水水水水水水水水水水水水水水水水树树树草草树树树树树树树树树树树草树树树树树树树草草草草树土無無
树水水水树树树树树树树树树树树树树水树树树草草树树树树树树树树树树树草树树树水水树树無草無無树土無门
树水水水树树树树树树树树树树树树树水树树树草草树树树树树树树草草草草草树树树水树树树草草草草草土土土
树水水水树树树树树树树树树树树树树水树树树草草草树树树树树树草草树树树树水水水树树树草草树树树树草草
水水水水树树树树树树树树树树树树树水树树树草草草树树树树草草草草树树水水水树树树树树草树树树树树树草
水水水水树树树树树树树树树树树树树水树树树草草草草草草草草草草草树树水树树草树树树树草树树树树树树草
水水水水树树树树树树树树树树树树树水水树树草草草水水水水水水水水水水水树树草草草树树草树树树树树树草
树树树树树树树树树树树树树树树树树树水树树草草草水水水水水水树树树树树树树树草草草草草树树树树树树草
树树树树树树树树树树树树树树树树树树水水水树树树水水水水水水草草草草草草草草草草草树树树树树树树树草