树树树树树树树树树树树树树树树树树树树树树树树树树树树树树树树树树树树树树树树树树树树树树树树水水水
树树树树树树树树树树树树树树树树树树树树树树树树树树树树树树树树树树树树树树树树树树树树树树树水水树
树树树树树树树树树树树树树树树树树树树树树树树树树树树树树树树树树树树树树树树树树树树树树树树水水树
树树树树树树树树树树树树树树树树树树树树树树树树树树树树树树树树树树树树树树树树树树树树树水水水水树
树树树树树树树树树树树树树树树树树树树树树树树树树土土土土土树树树树树树树树树树树树树树树水水水水树
树树树树树树树树树树树树树树树树树土土土土土土土树土树树树土树树树树草草草草树树树树水水水水水树树树
树树树树树树树树树树树树树树树树树土树树树树树土土土树土土土树树树树草草草草树树树树水水水水水树树树
树树树树树树树树树树树树树树树树树土土土土土树树树树树土树土土土土树草草草草树树树树水水树树树树石石
树树树树树树树树树树树树树树树树树树树树树土土土树土土土树树树树土树草草草草树树树树水水树树树树石石
树树树树树树树树树树树树树树树树树树土土土土树土树土树土土土土树土土土土道道道道道道道道道道道道草草
树树树树树树树树树树树树树树树树树树土树树树树土树树树土树树土树土树土土道道道道道道道道道道道道草草
树树树树树树树树树树树树树树树树树树土土土土树土土土土土树土土树土树土土道道树树树树水水草草草草草草
树树树树树树树树树树树树树树树树树树土树树土树土树土树树树树树树土树土土道道树树树树水水草草草草草草
树树树树树树树树树树树树標树树树树標土树土土树土树土树土土土土土土树土土道道水水水水水水草草草草土土
树树树树树树树道道道道道道道道道道道土树土树树土树土树土树土树树树树土土土土水水水水水水草草草草土土
树草草草草树树道道道道道道道道道道道土树土土土土树土树土树土土土土树土土土土水水树树树树草草草草土土
树草草草草树树道道树树树树树道道道道树树树树树土树土树土树树树土树树土草草草水水树树树树草草草草土土
道道道道道道道道道树树树树树道道道道树树树树树树树土土土树土土土树土土草草草水水树树树树树树树树树树
道道道道道道道道道树树树树树標道道道树树飾飾飾飾飾飾树土树树树树树土树草草草水水树树树树树树树树树树
树树树树树树树树树树树树树树道道道道飾無飾飾飾飾飾飾树土土土土土土土树草草草水水树树树树树树树树树树
树树树树树树树树树树树树树树道道道道道花無無無無無無树树树树树水水水水水水水水水树树树树树树树树树树
树树树树树树树树树树树树树树道道道道道花無门無無無無树树树树树水水水水水水水水水树树树树树树树树树树
树树树树树树树树树树树树树树草草道道道無無道道道道道道道树树树水水树树树树树树树树树树树树树树树树树
树树树树树树树树树树树树树树草草道道道道無道道道道道道道水水水水水树树树树树树树树树树树树树树树树树
树树树树树树树树树树树树树树树树道道道道無道道道道道水水水水水水水树树树树树树树树树树树树树树树树树
树树树树树树树树树树树树树树树树道道道道無道道道道道水水水水树树树树树树树树树树树树树树树树树树树树
树树树树树树树树树树树树树树树树草草道道無道水水水水水水水水树树树树树树树树树树树树树树树树树树树树
树树树树树树树树树树树树树树树树草草道道無無無無無無無無水水树树树树树树树树树树树树树树树树树树树树
树树树树树树树树树树树树树树树树草草道道道道道道道道草草水水树树树树树树树树树树树树树树树树树树树树
树树树树树树树树树树树树树树树树草草道道道道道道道道草草水水树树树树树树树树树树树树树树树树树树树树
树树树树树树树树树树树树树树树树树树草草草草草草道道道道水水树树树树树树树树树树树树树树树树树树树树
树树树树树树树树树树树树树树树树树树草草草草草草道道道道水水树树树树树树树树树树树树树树树树树树树树
树树树树树树树树树树树树树树树树树树道道道道草草草草道道水水树树树树树树树树树树树树树树树树树树树树
树树树树树树树树树树树树树树树树树树道道道道草草草草道道水水树树树树树树树树树树树树树树树树树树树树
树树树树树树树树树树树树树树树树树树草草草草草草草草道道水水树树树树树树树树树树树树树树树树树树树树
树树树树树树树树树树树树树树树树树树草草草草草草草草道道水水树树树树树树树树树树树树树树树树树树树树
树树树树树树树树树树树树树树树树树树草草草草草草道道道道水水树树树树树树树树树树树树树树树树树树树树
树树树树树树树树树树树树树树树树树树草草草草草草道道道道水水树树树树树树树树树树树树树树树树树树树树
树树树树树树树树树树树树树树树树树树草草土土土土道道草草水水树树树树树树树树树树树树树树树树树树树树
树树树树树树树树树树树树树树树树树树草草土飾土土道道草草水水树树树树树树树树树树树树树树树树树树树树
树树树树树树树树树树树树树树树树树树草草道道道道道道草草水水树树树树树树树树树树树树树树树树树树树树
树树树树树树树树树树树树树树树树树树草草道道道道道道草草水水树树树树树树树树树树树树树树树树树树树树
树水水水水水水水水水水水水水水水水水水水水道道水水水水水水水树树树树树草草草草草草草草草草草树树树树
树水水水水水水水水水水水水水水水水水水水水道道水水水水水水水树树草草草草树树树树树树草草草草草草树树
树水水水水水水水水水水水水水水水水水树树树草草树树树树树树树树树树树草树树树树树树树草草草草树树树树
树水水水树树树树树树树树树树树树树水树树树草草树树树树树树树树树树树草树树树水水树树無草無無树树树树
树水水水树树树树树树树树树树树树树水树树树草草树树树树树树树草草草草草树树树水树树树草草草草草草草树
树水水水树树树树树树树树树树树树树水树树树草草草树树树树树树草草树树树树水水水树树树草草树树树树草草
水水水水树树树树树树树树树树树树树水树树树草草草树树树树草草草草树树水水水树树树树树草树树树树树树草
水水水水树树树树树树树树树树树树树水树树树草草草草草草草草草草草树树水树树草树树树树草树树树树树树草
水水水水树树树树树树树树树树树树树水水树树草草草水水水水水水水水水水水树树草草草树树草树树树树树树草
树树树树树树树树树树树树树树树树树树水树树草草草水水水水水水树树树树树树树树草草草草草树树树树树树草
树树树树树树树树树树树树树树树树树树水水水树树树水水水水水水草草草草草草草草草草草树树树树树树树树草