树树树树树树树树树树树树树树树树树树树树树树树树树树树树树树树树树树树树树树树树树树树树树树树水水水
树树树树树树树树树树树树树树树树树树树树树树树树树树树树树树树树树树树树树树树树树树树树树树树水水树
树树树树树树树树树树树树树树树树树树树树树树树树树树树树树树树树树树树树树树树树树树树树树树树水水树
树树树树树树树树树树树树树树树树树树树树树树树树树树树树树树树树树树树树树树树树树树树树树水水水水树
树树树树树树树树树树树树树树树树树草草土土土土土草草草草土土土土树树树土土草树树树树树树树水水水水树
树树树树树树树树树树树树树树树树树草树树树土树树树土树草树土树土土草草草树草树树树树水水水水水树树树
树树树树树树树树树树树树树树树草草草土土树土草土土土树土树土树树树树树树树草树树树树水水水水水树树树
树树树树树树树树树树树树树树树草树树树土树草树树树树树草土土土土土树草草草草树树树树水水树树树树树树
树树树树树树树树树树树树树树树草树土土土草草草草树土草草树树树树土树树树树草树树树树水水树树树树树树
树树树树树树树树树树树树树树树草树树土树树草树草树土树草草土土树土土土土道道道道道道橋橋道道道道草草
树树树树树树树树树树树树树树树草草树土树草草树草树土树草树树土树土土土土道道道道道道橋橋道道道道草草
树树树树树树树树树树树树树树树树草树土树草树树草草土土土树土土树土树草树树树树树树树水水草草草草草草
树树树树树树树飾飾飾飾土土土土树草草土树草草树草树土树树树土树树土树草树草草稂树树树水水草草草┏┳┳
树树树树树树树無门無無土土土土树树树土树树草树草树土树土土土土土土树草草草树稂水水水水水草草草┣┏┳
树树树树树树树道道道道道道道道道道道土树稂草草草树土树土树草树树树树树树树树稂水水水水水草草草══土
草草草草稂树树道道道道道道道道道道道土树稂树草树树土树草树草草土土土草草草稂稂水树树树树草草草══土
水水草草稂树树土土树树土土土土土道道树树稂树草草草草树草树树树土树树树树树稂水水树树树树草草草══土
水树草水稂土土土土树树土土土土土道道树树稂树草树树草草草树草土土树土土稂树稂水水树树树树树树树┣┣树
草草草水稂土土土土树树土土土土土道道树树稂稂稂稂树树树草树草树树树土树稂树稂水水树树树树树树树┣┣树
水草草草稂草草树树树树稂树树树树道道树树树树树稂稂稂稂稂树土土土土土树稂稂稂水水树树树树树树树┣┣树
草草草草稂草草树树稂稂稂树树树树道道树树飾飾飾飾树树树稂稂稂树水水水水圯水水水水树树树树树树树┣┣树
草草水水稂草草树树稂水水树树树树道道树树無门買無树树树树树稂树水水水水圯水水水水树树树树树树树┣┣树
稂稂稂稂稂草草树树稂稂稂稂稂稂树道道道道道道道土草草草草树稂稂橋橋稂树稂树树树树树树树树树树树┣┣树
草草草草草草草稂树树水稂水水稂树道道道道道道道土草草草草水水水水水稂树稂树树树树树树树树树树树┣┣树
草草草草草草草稂稂树稂稂水稂稂树草草草草土道道土草草草草水水水水水稂稂稂树树树树树树树树树树树┣┣穴
树树树稂稂稂稂稂稂树水水水稂水树草草草草土道道土草草草草水水树树树树树树树树树树树树树树树树树┣┣穴
稂稂树稂稂稂稂稂稂树树树树稂水水稂稂草草土土土土土土土土水水树树树树树树树树树树树树树树树树树┣┣穴
稂稂树树稂稂树树稂树稂树树稂稂稂稂稂草草土土土土土土土土水水树树树树树树树树树树树树树树树树树┣┣穴
稂稂树稂稂稂树稂稂稂稂树树树树树稂稂草草草草草草土土稂稂水水树树树树树树树树树树树树树┏┳┳┳┳┣穴
树稂稂稂稂稂树树树树树树树树树树稂稂草草草草草草土土稂稂水水树树树树树树树树树树树树树┣┏┳┳┳┳穴
树树树树树树树树树树树树树树树树树树稂稂稂稂稂稂土土草草水水树树树树树树树树树树树树树┣┣穴穴穴穴穴
树树树树树树树树树树树树树树树树树树稂稂稂稂稂稂土土草草水水树树树树树树树树树树树树树┣┣穴穴穴穴穴
树树树树树树树树树树树树树树树树树树土土土土稂稂草草草草水水树树树树树树树树树树树┏┳┳┣穴穴穴穴穴
树树树树树树树树树树树树树树树树树树土土土土稂稂草草草草水水树树树树树树树树树树树┣树树┣穴穴穴穴穴
树树树树树树树树树树树树树树树树树树稂稂稂稂稂稂草草土土水水树树树树树树树树树树树┣树树┗┻┻┻┻┻
树树树树树树树树树树树树树树树树树树稂稂稂稂稂稂草草土土水水树树树树树树树树树树树┣树树树树树树树树
树树树树树树树树树树树树树树树树树树草草草草草草土土土土水水树树树树树树树树树树树┣水水水水水水水水
树树树树树树树树树树树树树树树树树树草草草草草草土土土土水水树树树树树树树树树树树┣水水水水水水水飾
树树树树树树树树树树树树树树树树树树稂稂土土草草草草稂稂水水树树树树树树树树树树树┣水水畑畑畑畑飾飾
树树树树树树树树树树树树树树树树树树稂稂土土草草草草稂稂水水树树树树树树树树树树树┣水水畑畑畑畑無無
树树树树树树树树树树树树树树树树树树稂稂土土土土土土稂稂水水水水水水水水水水水水水水水水畑畑畑畑花李
树树树树树树树树树树树树树树树树树树稂稂土土土土土土稂稂水水水水水水水水水水水水水水水飾飾飾飾土土土
树水水水水水水水水水水水水水水水水水水水水圯圯水水水水水水水树树树树树草草草草草草═草無门無無土飾飾
树水水水水水水水水水水水水水水水水水水水水圯圯水水水水水水水树树草草草草树树树树树┣草草土土土土飾飾
树水水水水水水水水水水水水水水水水水树树树草草树树树树树树树树树树树草树树树树树树┣草草草草树土無無
树水水水树树树树树树树树树树树树树水树树树草草树树树树树树树树树树树草树树树水水树┣無草無無树土無门
树水水水树树树树树树树树树树树树树水树树树草草树树树树树树树草草草草草树树树水树树┣草草草草草土土土
树水水水树树树树树树树树树树树树树水树树树草草草树树树树树树草草树树树树水水水树树┣草草树树树树草草
水水水水树树树树树树树树树树树树树水树树树草草草树树树树草草草草树树水水水树树树树┣草树树树树树树草
水水水水树树树树树树树树树树树树树水树树树草草草草草草草草草草草树树水树树草树树树┣草树树树树树树草
水水水水树树树树树树树树树树树树树水水树树草草草水水水水水水水水水水水树树草草草树┣草树树树树树树草
树树树树树树树树树树树树树树树树树树水树树草草草水水水水水水树树树树树树树树草草草═草树树树树树树草
树树树树树树树树树树树树树树树树树树水水水树树树水水水水水水草草草草草草草草草草草┗┻┻┻┻┻┻┻║
