???????????????
???????????????
???????????????
???????????????
???????????????
??_____????????
??_____????????
??_____????????
??_____????????
??__________???
??_____?____???
??_____?____???
??_____?____???
?????^?????????
???????????????