树树树树树树树树树树树树树树树道道道道石石石石石石石石石石石石石石石石石水水石石石石石石石石石石石石石石
树树树树树树树树树树树树树树道道道道石石石石石石石石石石石石石石石石石石水水石石石石石石石石石石石石石石
树树树树树树树树树树树树树道道道道道石石石石石石石石石飾石石石石石石石石水水石石石石石石石石石石石石石石
树树树树树树树树树树树树道道道道道石石石石石石石石石飾飾飾石石石石石石石水水石石石石石石石石石石石石石石
树树树树树树树树树树树树道道道道石石石石石石石石石飾飾無飾飾石石石石石石水水石石石石石石石石石石石石石石
树树树树树树树树树树树道道道道石石石石石石石石飾飾飾無無無飾飾飾石石石石水水石石石石石石石石石石石石石石
树树树树树树树树树树道道道道道水水水水水石石石飾飾無無门無無飾飾石石石石水水石石石石石石石石石石石石石石
树树树树树树树树树树道道道道水水水水水水水水石飾飾道道道道道飾飾石石石石水水石石石石石石石石石石石石石石
树树树树树树树树树树道道道水水水水水水水水水石飾飾道道飾道道飾飾石石石石水水石石石石石石石石石石石石石石
土土草草草草草草草草草草草草水水水水水水水水石飾飾道飾飾飾道飾飾石石水水水水石石石石石石石石石石石石石石
土草草草草草草草草草草草草草草水水水水水水水石飾飾飾飾無飾飾飾飾石石水水水水石石石石石石石石石石石石石石
土草草树树树树树树草草草草草草水水水水水水水石飾飾飾無無無飾飾飾石石水水水水石石石石石石石石石石石石石石
土树树树树树树树树草草草草草草水水水水水水水石無無無無门無無無無石石水水水水石石石石石石石石石石石石石石
草树树树树树树树树树草草草草草水水水水水水水石石石石道道道道石石石石水水水水石石石石石石石石石石石石石石
草树树树树树树树树树树草草草水水水水水水水水石石石石道道道道石石石石水水水水石石石石石石石石石石石石石石
草树树树树树树树树树树树树水水水水水水水水水石石石石道道飾道石石石石水水水水石石石石石石石石石石石石石石
飾树树树树树树树树树水水水水水水水水水水水水石石石石道道道道石石石石水水水土土土土土土石石石石石石石石石
無树树树树树树水水水水水水水水水水水水水水水水水水水水橋橋水水水水水水水水土土土土土土石石石石石石石石石
草草树树树树水水水水水水水水水水水水水水水水水水水水水橋橋水水水水水水水水土土土土土土石石石石石石石石石
草草树树树水水水水水水水水水水水水水水水水水树树树树道道道道水水水水水水水土土土土土土石石石石石石石石石
土土土土土土水水水水水水水水水水水水水水水水树树树树道道道道道花土花土花無土土土土土土石石石石石石石石石
土土土土土土水水树树树树飾飾飾飾树树水水飾飾飾飾飾飾道道道道道土飾飾飾飾飾土石石石石石石石石石石石石石石
土土草草草草水水树树树树飾飾飾飾土土水水飾飾飾飾飾飾道道道道道花飾飾飾飾飾土石石石石石石石石石石石石石石
土土草草草草水水树树树树無無無無土土土土無無無無無無道道道道道土飾飾飾飾飾门石石石石石石石石石石石石石石
道道道道道道橋橋道道道道無门無無土土土土無無门競無無道道道道道花無無门無無無石石石石石石石石石石石石石石
道道道道道道橋橋道道道道道道道道道道道道道道道道道道道道道道道土花土道土花土石石石石石石石石石石石石石石
树树树树树树水水土土道道道道道道道道道道道道道道道道道道道道道道道道道道土土石石石石石石石石石石石石石石
树树树树树树水水水水树树土土土土土土土土土土土土土土道道飾道道道道道道道土土石石石石石石石石石石石石石石
树树树树树树水水水水树树树树树树土土土土土土土土土土道道道道道道道道道道土土石石石石石石石石石石石石石石
树树树树树树树树水水树树树树树树土土土土土土树树树树树树树树道道道道飾飾飾飾石石石石石石石石石石石石石石
树树树树树树树树水水树树树树树树土土树树树树树树树树树树树树無道無無飾飾飾飾石石石石石石石石石石石石石石
树树树树树树树树水水树树树树树树土土树树树树树树树树树树树树道道道道無無無無石石石石石石石石石石石石石石
树树树树树树树树水水树树树树树树土土树树树树树树树树树树树树道道道道無门無無土土石石石石石石石石石石石石
树树树树树树树树水水树树树树树树土土树树树树树树树树树树树树道道道道道道道道道道道石石石石石石石石石石石
树树树树树树树树水水树树树树树树土土土土树树树树飾飾飾飾土土道道道道道道道道道道道石石石石石石石石石石石
石石石石石石石树水水树树树树树树土土土土树树树树飾飾飾飾土花道道道道土花土花土道道石石石石石石石石石石石
石石石石石石石树水水树树树树树树土土土土树树树树無门無無花土道道道道花土花土花道道石石石石石石石石石石石
石石石石石石石树水水树树树树树树土土土土树树树树道道道道道道道道道道土土土土標道道石石石石石草草草草石石
石石石石石石石树水水树树树树树树石石土土树树树树道道道道道道道道道道土土土土土道道石石石石石草草草草石石
石石石石石石石树水水树树树树树树石石土土树树树树树树树树树树树树土土土土土土土道道道道土土土土土草草石石
石草草草草土土草橋橋草草草嶝嶝嶝石石土土土土土土土土土土土土土树土土土土土土土道道道道土土土土土草草石石
石草草草草土土草橋橋草草草嶝嶝嶝石石土土树树树树树土土飾飾飾飾树树树树树树树树树树树树树树树树树草草土土
石石石草草石石树水水稂稂稂稂嶝嶝石石土土树树树树树土土無门無無花土花土树树树树树树树树树树树树树草草土土
石石石草草石石树水水稂稂稂稂嶝嶝嶝嶝土土土土树树树土土土土土土土花土花树树树树树树树树树树树树树草草稂稂
草石石草草石石树水水石石石石嶝嶝嶝嶝土土土土树树树土土土土土土花土花土树树树石石石石石石石石石石草草稂稂
草石石草草石石树水水石石石石石石石石树树土土树树树树树土土树树树树树树树树树石石石石石石石石石石草草稂稂
草石石草草石石树水水飾飾飾飾石石石石石石土土树畑畑畑畑畑畑畑畑畑树树树树树树石石石石石石石石土土土土土土
草土花土花石石石水水無门無無石石石石石石土土树畑畑畑畑畑畑畑畑畑树树树树树树石石石石石石石石土土土土土土