???????????????
???????????????
???????????????
???????????????
???????????????
??_____????????
??_____????????
??_____????????
??__???????????
??__?_______???
??__?_______???
??__?_______???
??__________???
?????^?????????
???????????????