树树树树树树树树树树树水水水水树树树树树树树树树树树树树树树树树树树树树树树树树树树树树树树树树树树树树树树树树树树树树树树树树树树树树树树树树
树树树树树树树树树树树水水水水树树树树树树树树树树树树树树树树树树树树树树树树树树树树树树树树树树树树树树树树树树树树树树树树树树树树树树树树树
草草草草树树树树水水水水水树树树树树树树树树树树树树树树树树树树树树树树树树树树树树树树树树树树树树树树树树树树树树树树树树树树水水水水水水水水
草草草草树树树树水水水水水树树树树树树树树树树树树树树树树树树树树树树树树树树树树树树树树树树树树树树树树树树树树树树树树树树树水水水水水水水水
草草草草树树树树水水树树树树石石石石石石石石石石树树树树树树树树树树树树树树树树树树树树树树树树树树树树树树树树树树树树树树树树水水水水水水水水
草草草草树树树树水水树树树树石石石石石石石石石石树树树树树树树树树树树树树树树树树树树树树树树树树树树树树树树树树树树树树树树树水水水水水水水水
土土道道道道道道道道道道道道草草草草草草树树树树树树树树树树树树树树树树树树树树树树树树树树树树树树树树树树树树树树树树树树树树树树树树水水水水
土土道道道道道道道道道道道道草草草草草草树树树树树树树树树树树树树树树树树树树树树树树树树树树树树树树树树树树树树树树树树树树树树树树树水水水水
土土道道树树树树水水草草草草草草草草草草树树树树树树树树树树树树树树树树树树树树树树树树树树树树树树树树树树树树树树树树树树树树树树树树水水水水
土土道道树树树树水水草草草草草草草草草草土土土土树树树树树树树树树树树树树树树树树树树树树树树树树树树树树树树树树树树树树树树树树树树树水水水水
土土道道水水水水水水草草草草土土土土道道土土土土树树树树树树树树树树树树树树树树树树树树树树树树树树树树树树树树树树树树树树树树树树树树水水水水
土土土土水水水水水水草草草草土土土土道道土土土土树树树树树树树树飾飾飾飾树树树树树树树树树树树树树树树树树树树树树树树树树树树树树树树树水水水水
土土土土水水树树树树草草草草土土土土道道土土土土树树树树树树树树無门無無树树树树树树树树树树树树树树树树树树树树树树树树树树树树树树树树水水水水
土草草草水水树树树树草草草草土土土土道道草草土土树树树树土土道道道道道道道道草草草草草草树树树树树树树树树树树树树树树树树树树树树树树树水水水水
土草草草水水树树树树树树树树树树草草道道草草土土树树树树土土道道道道道道道道草草草草草草树树树树树树树树树树树树树树树树树树树树树树树树水水水水
树草草草水水树树树树树树树树树树草草道道草草草草树树树树土土道道土土草草道道草草土土土土土土土土土土土土土土土土树树树树树树树飾飾飾飾树水水水水
树草草草水水树树树树树树树树树树草草道道草草草草树树树树土土道道土土草草道道草草土土土土土土土土土土土土土土土土树树树树树树树飾飾飾飾树水水飾飾
水水水水水水树树树树树树树树树树草草道道草草草草草草草草草草草草草草土土道道草草土土土土土土土土土土土土草草草草树树树树树树树無無無無土水水飾飾
水水水水水水树树树树树树树树树树草草道道草草草草草草草草草草草草草草土土道道草草土土土土土土土土土土土土草草草草树树树树树树树無门無無土土土無無
树树树树树树树树树树树树树树树树树树道道道道道道土土土土草草草草草草土土道道道道道道道道道道道道道道道道道道道道道道道道道道道道道道土土土飾無無
树树树树树树树树树树树树树树树树树树道道道道道道土土土土草草草草草草土土道道道道道道道道道道道道道道道道道道道道道道道道道道道道道道道道道道道道
树树树树树树树树树树树树树树树树树树树树树树树树树树树树树树树树树树土土草草土土道道草草草草土土树树树树树树树树树树树树树树树花土道道道道道道道
树树树树树树树树树树树树树树树树树树树树树树树树树树树树树树树树树树树树草草土土道道草草草草土土树树树树树树树树树树树树树树树土花土土土土土土土
树树树树树树树树树树树树树树树树树树树树树树树树树树树树树树树树树树树树土土草草土土草草草草土土树树树树树树树树树树树树树树树树树树土土土土土土
树树树树树树树树树树树树树树树树树树树树树树石石石树树树树树树树树树树树土土草草土土草草草草土土树树树树树树树树树树树树树树树树树树土土土土土土
树树树树树树树树树树树树树树树树树树树树树树石石石石石石石树树树树树树树草草草草草草草草土土土土树树树树树树树树树树树树树树树树树树土土树树树树
树树树树树树树树树树树树树树树树树树树树树石石石石石石石石石石石石树树树草草草草草草草草土土土土树树树树树树树树树树树树树树树树树树土土树树树树
树树树树树树树树树树树树树树树树树树树树树石石石石石石石石石石石石石石石石石树树稂稂树树树树树树树树树树树树树树树树树树树树树树树树土土树树树树
树树树树树树树树树树树树树树树树树树树树树石石石石石石石石石石石石石石石石石树树稂稂树树树树树树树树树树树树树树树树树树树树树树树树土土树树树树
树树树树树树树树树树树树树树树树树树树树树石石石石石石石石石石石石石石石石石石石稂稂树树树树树树树树树树树树树树树树树树树树树树树树土土土土树树
树树树树树树树树树树树树树树树树树树树树石石石石石石石石石石石石石石石石石石石石稂稂石石石石石石石石石石石石石石石树树树树树树树树树土土土土树树
树树树树树树树树树树树树树树树树树树树树石石石石石石石石石石石石石石石石石石石石稂稂石石石石石石石石石石石石石石石树树树树树树树树树土土土土树树
树树树树树树树树树树树树树树树树树树树树石石石石石石石石石石石石石石石石石石石石稂稂石石石石石石石石石石石石石石石树無树树树树树树树土土土土树树
树树树树树树树树树树树树树树树树树树树树石石石石石石石石石石石石石石石石石石石石稂稂飾飾飾飾石石石石石石石石石石石树树树树树树树树树树树土土树树
树树树树树树树树树树树树树树树树树树树石石石石石石石石石石石石石石石石石石石石石草草無门無無石石石石石石石石石石石树树树树树树树树树树树土土树树
树树树树树树树树树树树树树树树树树树树石石石石石石石石石石石石石石石石石石石石石草草土土土土土石石石石草草草草土土土草草草草草土土土土土土土树树
树树树树树树树树树树树树树树树树树树树石石石石石石石石石石石石石石石石石石石石石草草土土土土土石石石石草草草草土土土草草草草草土土土土土土土树树
树树树树树树树树树树树树树树树树树树树石石石石石石石石石石石石石石石石石石石石石草草石石石草草石石石石石石草草石石树树树树树树树土土土土土土土土
树树树树树树树树树树树树树树树树树树石石石石石石石石石石石石石石石石石石石石石石草草石石石草草石石石石石石草草石石树树树树树树树土飾土土土土土土
树草草草草草草草草草草草树树树树树树石石石石石石石石石石石石石石石石石石石石石石土土石石石稂稂稂稂草草石石草草石石树树树石石石石石石石石树树土土
草草树树树树树树草草草草草草树树树树石石石石石石石石石石石石石石石石石石石石石石土土石石石稂稂稂稂草草石石草草石石树树树石石石石石石石石树树土土
草树树树树树树树草草草草树树树树树树石石石石石石石石石石石石石石石石石石入石石石土土石石石石石石石草草石石草草石石树树树飾飾飾飾石石石石石石土土
草树树树树树树树無草無無树树树树树石石石石石石石石石石石石石石石石石石石草草石石土土石石石石石石石草草土花土花石石树树树無门無無石石石石石石土土
草树树树树树树树草草草草草草草树树石石石石石石石石石石石石石石石石石石石草草石石土土草草稂稂石石石草草花土花土石石树树树道道道道石石石石石石土土
树树树树树树树树草草树树树树草草树石石石石石石石石石石石石石石石石石石石草草石石土土草草稂稂石石石石石石石石石石石树树树道道道道石石石石石石土土