树树树树树树树树树树树水水水水树树树树树树树树树树树树树树树树树树树树树树树树树树树树树树树树树树树树树树树树树树树树树树树树树树树树树树树树树
树树树树树树树树树树树水水水水树树树树树树树树树树树树树树树树树树树树树树树树树树树树树树树树树树树树树树树树树树树树树树树树水水水水水水水树树
草草草草树树树树水水水水水树树树树树树树树树树树树树树树树树树树树树树树树树树树树树树树树树树树树树树树树树树树树树树树树树树水水水水水水水水水
草草草草树树树树水水水水水树树树树树树树树树树树树树树树树树树树树树树树树树树树树树树树树树树树树树树树树树树树树树树树树树树水水水水水水水水水
草草草草树树树树水水树树树树石石石石石石石石石石树树树树树树树树树树树树树树树树树树树树树树树树花土土土草草草草草草草草草草草草水水水水水水水水
草草草草树树树树水水树树树树石石石石石石石石石石树树树树树树树树树树树树树树树树树树树树树树树花土花土草草草草草草草草草草草草草草水水水水水水水
土土道道道道道道道道道道道道草草草草草草树树树树树树树树树树树树树树树树树树树树树树树树树树花土花土土草草树树树树树树草草草草草草水水水水水水水
土土道道道道道道道道道道道道草草草草草草树树树树树树树树树树树树树树树树树树树树树树树树树树土花土土土树树树树树树树树草草草草草草水水水水水水水
土土道道树树树树水水草草草草草草草草草草树树树树树树树树树树树树树树树树树树树树树树树树树树土土土土草树树树树树树树树树草草草草草水水水水水水水
土土道道树树树树水水草草草草草草草草草草土土土土树树树树树树树树树树树树树树树树树树树树树树树草土土草树树树树树树树树树树草草草水水水水水水水水
土土道道水水水水水水草草草草土土土土道道土土土土树树树树树树树树树树树树树树树树树树树树树树树草土草草树树树树树树树树树树树树水水水水水水水水水
土土土土水水水水水水草草草草土土土土道道土土土土树树树树树树树树飾飾飾飾树树树树树树树树树树树飾门飾飾树树树树树树树树树水水水水水水水水水水水水
土土土土水水树树树树草草草草土土土土道道土土土土树树树树树树树树無门無無树树树树树树树树树树树無门無無树树树树树树水水水水水水水水水水水水水水水
土草草草水水树树树树草草草草土土土土道道草草土土树树树树土土道道道道道道道道草草草草草草树树草草土土草草树树树树水水水水水水水水水水水水水水水水
土草草草水水树树树树树树树树树树草草道道草草土土树树树树土土道道道道道道道道草草草草草草树树草草土土草草树树树水水水水水水水水水水水水水水水水水
树草草草水水树树树树树树树树树树草草道道草草草草树树树树土土道道土土草草道道草草土土土土土土土土土土土土土土土土水水水水水水水水水水水水水水水水
树草草草水水树树树树树树树树树树草草道道草草草草树树树树土土道道土土草草道道草草土土土土土土土土土土土土土土土土水水树树树树飾飾飾飾树树水水飾飾
水水水水水水树树树树树树树树树树草草道道草草草草草草草草草草草草草草土土道道草草土土草草草草土土草草土土草草草草水水树树树树飾飾飾飾土土水水飾飾
水水水水水水树树树树树树树树树树草草道道草草草草草草草草草草草草草草土土道道草草土土草草草草土土草草土土草草草草水水树树树树無無無無土土土土無無
树树树树树树树树树树树树树树树树树树道道道道道道土土土土草草草草草草土土道道道道道道草草草草道道草草道道道道道道道道道道道道無门無無土土土飾無無
树树树树树树树树树树树树树树树树树树道道道道道道土土土土草草草草草草土土道道道道道道草草草草道道草草道道道道道道道道道道道道道道道道道道道道道道
树树树树树树树树树树树树树树树树树树树树树树树树树树树树树树树树树树土土草草土土道道草草稂稂土土草草树树树树树树水水土土道道道道道道道道道道道道
树树树树树树树树树树树树树树树树树树树树树树树树树树树树树树树树树树树树草草土土道道草草稂稂土土草草树树树树树树水水水水树树土土土土土土土土土土
树树树树树树树树树树树树树树树树树树树树树树树树树树树树树树树树树树树树土土草草土土草草稂稂草草树树树树树树树树水水水水树树树树树树土土土土土土
树树树树树树树树树树树树树树树树树树树树树树石石石树树树树树树树树树树树土土草草土土草草稂稂草草树树树树树树树树树树水水树树树树树树土土土土土土
树树树树树树树树树树树树树树树树树树树树树树石石石石石石石树树树树树树树草草草草草草草草稂稂稂稂树树树树树树树树树树水水树树树树树树土土树树树树
树树树树树树树树树树树树树树树树树树树树树石石石石石石石石石石石石树树树草草草草草草草草稂稂稂稂树树树树树树树树树树水水树树树树树树土土树树树树
树树树树树树树树树树树树树树树树树树树树树石石石石石石石石石石石石石石石石石树树稂稂树树树树树树树树树树树树树树树树水水树树树树树树土土树树树树
树树树树树树树树树树树树树树树树树树树树树石石石石石石石石石石石石石石石石石树树稂稂树树树树树树树树树树树树树树树树水水树树树树树树土土树树树树
树树树树树树树树树树树树树树树树树树树树树石石石石石石石石石石石石石石石石石石石稂稂树树树树树树树树树树树树树树树树水水树树树树树树土土土土树树
树树树树树树树树树树树树树树树树树树树树石石石石石石石石石石石石石石石石石石石石稂稂石石石石石石石石石石石石石石石树水水树树树树树树土土土土树树
树树树树树树树树树树树树树树树树树树树树石石石石石石石石石石石石石石石石石石石石稂稂石石石石石石石石石石石石石石石树水水树树树树树树土土土土树树
树树树树树树树树树树树树树树树树树树树树石石石石石石石石石石石石石石石石石石石石稂稂石石石石石石石石石石石石石石石树水水树树树树树树土土土土树树
树树树树树树树树树树树树树树树树树树树树石石石石石石石石石石石石石石石石石石石石稂稂飾飾飾飾石石石石石石石石石石石树水水树树树树树树石石土土树树
树树树树树树树树树树树树树树树树树树树石石石石石石石石石石石石石石石石石石石石石道道無门無無石石石石石石石石石石石树水水树树树树树树石石土土树树
树树树树树树树树树树树树树树树树树树树石石石石石石石石石石石石石石石石石石石石石道道道道道道道石石石石草草草草土土草道道草草草嶝嶝嶝石石土土树树
树树树树树树树树树树树树树树树树树树树石石石石石石石石石石石石石石石石石石石石石道道道道道道道石石石石草草草草土土草道道草草草嶝嶝嶝石石土土树树
树树树树树树树树树树树树树树树树树树树石石石石石石石石石石石石石石石石石石石石石道道石石石道道石石石石石石草草石石树水水稂稂稂稂嶝嶝石石土土土土
树树树树树树树树树树树树树树树树树树石石石石石石石石石石石石石石石石石石石石石石道道石石石道道石石石石石石草草石石树水水稂稂稂稂嶝嶝嶝嶝土土土土
树草草草草草草草草草草草树树树树树树石石石石石石石石石石石石石石石石石石石石石石嶝嶝石石石稂稂稂稂草草石石草草石石树水水石石石石嶝嶝嶝嶝土土土土
草草树树树树树树草草草草草草树树树树石石石石石石石石石石石石石石石石石石石石石石嶝嶝石石石稂稂稂稂草草石石草草石石树水水石石石石石石石石树树土土
草树树树树树树树草草草草树树树树树树石石石石石石石石石石石石石石石石石石入石石石嶝嶝石石石石石石石草草石石草草石石树水水飾飾飾飾石石石石石石土土
草树树树水水树树無草無無树树树树树石石石石石石石石石石石石石石石石石石石嶝嶝石石嶝嶝石石石石石石石草草土花土花石石石水水無门無無石石石石石石土土
草树树树水树树树草草草草草草草树树石石石石石石石石石石石石石石石石石石石嶝嶝石石嶝嶝嶝嶝嶝嶝石石石草草花土花土石石石水水道道道道石石石石石石土土
树树水水水树树树草草树树树树草草树石石石石石石石石石石石石石石石石石石石嶝嶝石石嶝嶝嶝嶝嶝嶝石石石石石石石石石石石石水水道道道道石石石石石石土土