無無無無無無無無無無無無無無無
無無無無無無無無無無無無無無無
無無無無無無無無门無無無無無無
無無道道道道無道道道道道道無無
無無道無無道無道道道道道道無無
無無道道道道無道道道道道道無無
無無道道道道道道道道道道道無無
無無道道道道無道道道道道道無無
無無無道無無無無無無道道道無無
無無道道道道道道道無無道無無無
無無道道道道道道道無道道路無無
無無道道道道道道道道道道橋無無
無無道道道道道道道無路路路無無
無無無無無门無無無無無無無無無
無無無無無無無無無無無無無無無