無無無無無無無無無無無無無無無無無無無無無無無無無無無
無無無無無無無無無無無無無無無無無無無無無無無無無無無
無無無無無無無無無無無無無無無無無無無無無無無無無無無
無無無無無無無無無無無無無無無無無無無無無無無無無無無
無無無無無無無無無無無無無無無無無無無無無無無無無無無
無無無無無無無無土土土土土土土土土土土無無無無無無無無
無無無無無無無無土花土土土花土土土花土無無無無無無無無
無無無無無無無無土土花土無土花土花土土無無無無無無無無
無無無無無無無無土土花土花土花土花土土無無無無無無無無
無無無無無無無無土花土土土無土土土花土無無無無無無無無
無無無無無無無無土土土土土土土土土土土無無無無無無無無
無無無無無無無無無無無無無土無無無無無無無無無無無無無
無無無無無無無無無無無無土土土無無無無無無無無無無無無
無無無無無無無無無無無無土無土無無無無無無無無無無無無
無無無無無無無無無無無無土土土無無無無無無無無無無無無
無無無無無無無無無無無無無土無無無無無無無無無無無無無
無無無無無無無無無無無土土土土土無無無無無無無無無無無
無無無無無無無無無無無土無土無土無無無無無無無無無無無
無無無無無無無無無無無土土土土土無無無無無無無無無無無
無無無無無無無無無無無土無土無土無無無無無無無無無無無
無無無無無無無無無無無土土土土土無無無無無無無無無無無
無無無無無無無無無無無無無土無無無無無無無無無無無無無
無無無無無無無無無無無無土土土無無無無無無無無無無無無
無無無無無無無無無無無無土無土無無無無無無無無無無無無
無無無無無無無無無無無無土土土無無無無無無無無無無無無
無無無無無無無無無無無無無土無無無無無無無無無無無無無
無無無無無無無無無無無無無無無無無無無無無無無無無無無