無無無無無無無無無無無無無無無無無無無無無無無無無無無
無無無無無無無無無無無無無無無無無無無無無無無無無無無
無無無無無無無無無無無無無無無無無無無無無無無無無無無
無無無無無無無無無無無無無無無無無無無無無無無無無無無
無無寺寺寺寺寺寺寺寺寺寺寺寺寺寺寺寺寺寺寺寺寺寺寺無無
無無寺寺寺寺寺寺寺寺寺寺寺寺寺寺寺寺寺寺寺寺寺寺寺無無
無無寺寺寺寺寺寺寺寺寺寺寺寺寺寺寺寺寺寺寺寺寺寺寺無無
無無寺寺寺寺寺寺寺寺寺寺寺寺寺寺寺寺寺寺寺寺寺寺寺無無
無無寺寺寺寺寺寺寺寺寺寺寺寺寺寺寺寺寺寺寺寺寺寺寺無無
無無寺寺寺寺寺寺寺寺寺寺寺寺寺寺寺寺寺寺寺寺寺寺寺無無
無無寺寺寺寺寺寺寺寺寺寺寺寺寺寺寺寺寺寺寺寺寺寺寺無無
無無寺寺寺寺寺寺寺寺寺寺寺寺寺寺寺寺寺寺寺寺寺寺寺無無
無無寺寺寺寺寺寺寺寺寺寺寺寺寺寺寺寺寺寺寺寺寺寺寺無無
無無寺寺寺寺寺寺寺寺寺寺寺寺寺寺寺寺寺寺寺寺寺寺寺無無
無無寺寺寺寺寺寺寺寺寺寺寺寺寺寺寺寺寺寺寺寺寺寺寺無無
無無寺寺寺寺寺寺寺寺寺寺寺寺寺寺寺寺寺寺寺寺寺寺寺無無
無無寺寺寺寺寺寺寺寺寺寺寺寺寺寺寺寺寺寺寺寺寺寺寺無無
無無寺寺寺寺寺寺寺寺寺寺寺寺寺寺寺寺寺寺寺寺寺寺寺無無
無無寺寺寺寺寺寺寺寺寺寺寺寺寺寺寺寺寺寺寺寺寺寺寺無無
無無寺寺寺寺寺寺寺寺寺寺寺寺寺寺寺寺寺寺寺寺寺寺寺無無
無無寺寺寺寺寺寺寺寺寺寺寺寺寺寺寺寺寺寺寺寺寺寺寺無無
無無寺寺寺寺寺寺寺寺寺寺寺寺寺寺寺寺寺寺寺寺寺寺寺無無
無無寺寺寺寺寺寺寺寺寺寺寺寺寺寺寺寺寺寺寺寺寺寺寺無無
無無寺寺寺寺寺寺寺寺寺寺寺寺寺寺寺寺寺寺寺寺寺寺寺無無
無無寺寺寺寺寺寺寺寺寺寺寺寺寺寺寺寺寺寺寺寺寺寺寺無無
無無無無無無無無無無無無無土無無無無無無無無無無無無無
無無無無無無無無無無無無無無無無無無無無無無無無無無無