树树树树树树树树树树树树树树树树树树树树树树树树树树树树树树树树树树树树树树树树树树树树树树
树树树树树树树树树树树树树树树树树树树树树树树树树树树树树树树树树树树树树树树树树树树树树树
树树树树树树树树树树树树树树树树树树树树树树树树树树树树树树树树树树树树树树树树树树树树树树
树树树树树树树树树树树树树树树树树树树树树树树树树树树树树树树树树树树树树树树树树树树树树树
树树树树树树树树树树树树树树树树树树树树树树树树树树树树树树树树树树树树树树树树树树树树树树
树树树树树树树树树树树树树树树树树树树树树树树树树树树树树树树树树树树树树树树树树树树树树树
树树树树树树树树树树树树树树树树树飾飾飾飾飾飾飾飾飾树树树树树树树树树树树树树树树树树树树树
树树树树树树树树水水水水水水水水树飾飾飾飾飾飾飾飾飾树树树树树树树树树树树树树树树树树树树树
树树树树树树树树水水水水水水水水树飾飾無無無無無飾飾树树树树树树树树树树树树树树树树树树树树
树树树树树树树树水水水水水水水水树飾飾道道道道道飾飾树树水水水水树树树树树树树树树树树树树树
树树树树树树树树水水水水水水水水树飾飾飾飾飾飾飾飾飾树树水水水水树树树树树树树树树树树树树树
树树树树树树树树树树树树水水水水树飾飾飾飾飾飾飾飾飾树树水水水水树树树树树树树树树树树树树树
树树树树树树树树树树树树水水水水树無無無無门無無無無树树水水水水树树树树树树树树树树树树树树
树树树树树树树树树树树树水水水水树树树树道道道道树树树树水水水水树树树树树树树树树树树树树树
树树树树树树树树树树树树水水水水树树树树道道道道树树树树水水水水树树树树树树树树树树树树树树
树树树树树树树树树树树树水水水水树树树树道道飾道树树树树水水水水树树树树树树树树树树树树树树
树树树树树树树树树树树树水水水水树树树树道道道道树树树树水水水土土土土土土树树树树树树树树树
树树树树树树树树树树树树水水水水树树树树道道道道水水水水水水水土土土土土土树树树树树树树树树
树树树树树树树树树树树树水水水水树树树树道道道道水水水水水水水土土土土土土树树树树树树树树树
树树树树树树树树树树树树水水水水树树树树道道道道水水水水水水水土土土土土土树树树树树树树树树
树树树树树树树飾飾飾飾树水水水水树树树树道道道道水水水水水水水土土土土土土树树树树树树树树树
树树树树树树树飾飾飾飾树水水飾飾飾飾飾飾道道道道花土树树树树树树树树土树树树树树树树树树树树
树树树树树树树無無無無土水水飾飾飾飾飾飾道道道道土花飾飾飾飾飾飾树树土树树树树树树树树树树树
树树树树树树树無门無無土土土無無無無無無道道道道土土飾飾飾飾飾门土土土树树树树树树树树树树树
道道道道道道道道道道土土土飾無無门無無無道道道道土飾無無门無無無树树树树树树树树树树树树树树
道道道道道道道道道道道道道道道道道道道道道道道道道道道道道道土土树树树树树树树树树树树树树树
树树树树树树树花土道道道道道道道道道道道道道道道道道道道道道土土树树树树树树树树树树树树树树
树树树树树树树土花土土土土土土土土土土土道道飾道道道道道道道土土树树树树树树树树树树树树树树
树树树树树树树树树树土土土土土土土土土土道道道道道道道道道道土土树树树树树树树树树树树树树树
树树树树树树树树树树土土土土土土树树树树树树树树道道道道飾飾飾飾树树树树树树树树树树树树树树
树树树树树树树树树树土土树树树树树树树树树树树树無道無無飾飾飾飾树树树树树树树树树树树树树树
树树树树树树树树树树土土树树树树树树树树树树树树道道道道無無無無树树树树树树树树树树树树树树
树树树树树树树树树树土土树树树树树树树树树树树树道道道道無门無無土土树树树树树树树树树树树树
树树树树树树树树树树土土树树树树树树树树树树树树道道道道道道道道道道道树树树树树树树树树树树
树树树树树树树树树树土土土土树树树树飾飾飾飾土土道道道道道道道道道道道树树树树树树树树树树树
石树树树树树树树树树土土土土树树树树飾飾飾飾土花道道道道土花土花土道道树树树树树树树树树树树
石树树树树树树树树树土土土土树树树树無门無無花土道道道道花土花土花道道树树树树树树树树树树树
石树無树树树树树树树土土土土树树树树道道道道道道道道道道土土土土標道道树树树树树草草草草树树
石树树树树树树树树树树树土土树树树树道道道道道道道道道道土土土土土道道树树树树树草草草草树树
石树树树树树树树树树树树土土树树树树树树树树树树树树土土土土土土土道道道道土土土土土草草树树
土土草草草草草土土土土土土土树树树树树树树树树树树树土土土土土土土道道道道土土土土土草草树树
土土草草草草草土土土土土土土树树树树树树树飾飾飾飾树树树树树树树树树树树树树树树树树草草土土
石树树树树树树树土土土土土土土土树树树树树無门無無树树树树树树树树树树树树树树树树树草草土土
石树树树树树树树土飾土土土土土土树树树树树土土土土树树树树树树树树树树树树树树树树树草草稂稂
石树树树石石石石石石石石树树土土树树树树树土土土土土树树树树树树树树树树树石石石石石草草稂稂
石树树树石石石石石石石石树树土土树树树树树树树土树树树树树树树树石石石石石石石石石石草草稂稂
石树树树飾飾飾飾石石石石石石土土树树树树树树树土树树树树树树树树石石石石石石石石土土土土土土
石树树树無门無無石石石石石石土土树树树土土土土土树树树树树树树树石石石石石石石石土土土土土土