無無無無無無無無無無無無無無無無無無無無無無無無無無無
無無無無無無無無無無無無無無無無無無無無無無無無無無無
無無無無無無無無無無無無無無無無無無無無無無無無無無無
無無無無無無無無無無無無無無無無無無無無無無無無無無無
無無無無無無無無無無無無無無無無無無無無無無無無無無無
無無無無無無無無無無無無無無無無無無無無無無無無無無無
無無無無無無無無無無無無無無無無無無無無無無無無無無無
無無無無無無無無無無無無無门無無無無無無無無無無無無無
無無無無無無無無無無無無無寺無無無無無無無無無無無無無
無無無無無無無無寺無無無寺寺寺無無無寺無無無無無無無無
無無無無無無無寺寺寺寺寺寺寺寺寺寺寺寺寺無無無無無無無
無無無無無無無寺寺寺寺寺寺寺寺寺寺寺寺寺無無無無無無無
無無無無無無無寺寺花土土土土土土土土寺寺無無無無無無無
無無無無無無無寺寺土水水水水水水水土寺寺無無無無無無無
無無無無無無無寺寺土水花土树土土水花寺寺無無無無無無無
無無無無無無無寺寺土水土土仏土花水土寺寺無無無無無無無
無無無無無無無寺寺土水土土土土花水土寺寺無無無無無無無
無無無無無無無寺寺土水水水水水水水土寺寺無無無無無無無
無無無無無無無寺寺土土花土花土土土土寺寺無無無無無無無
無無無無無無無寺寺寺寺寺寺寺寺寺寺寺寺寺無無無無無無無
無無無無無無無寺寺寺寺寺寺寺寺寺寺寺寺寺無無無無無無無
無無無無無無無無無無無無寺寺寺無無無無無無無無無無無無
無無無無無無無無無無無無寺寺寺無無無無無無無無無無無無
無無無無無無無無無無無無寺寺寺無無無無無無無無無無無無
無無無無無無無無無無無無寺寺寺無無無無無無無無無無無無
無無無無無無無無無無無無無门無無無無無無無無無無無無無
無無無無無無無無無無無無無無無無無無無無無無無無無無無