無無無無無無無無無無無無無無無
無無無無無無無無無無無無無無無
無無無無無無無無無無無無無無無
無無無無無無無無無無無無無無無
無無無無無無無無無無無無無無無
無無無無無無無無無無無無無無無
無無無無無無無無無無無無無無無
無無無無無無無無土無無無無無無
無道道道道道道道道道無無無無無
無道無無道道道道道道無無無無無
無道無無道道道道道道無無無無無
無道道道道道道道道道無無無無無
無道道道道道道道道道無無無無無
無無無無無土無無無無無無無無無
無無無無無無無無無無無無無無無