┏┣┣┣穴穴穴穴穴穴穴穴穴穴穴┫穴穴┫┳┳┳┳┳
┣┣┣┣穴穴穴穴穴穴穴穴穴穴穴┫穴穴┫穴┫┳┳┳
┣┣┣┣穴穴┏┳u┳┓穴穴穴穴┫穴穴┫穴┫穴穴穴
┣┣┣┣穴穴┗┻┻┻┛穴穴穴穴─穴穴┫穴┫穴穴穴
┣┣┣┗┻║┻┻┻┻┻║┻┻┻┛穴穴─穴┫穴穴穴
┣┣┗┻┻║┻┻┻┻┻║┻┻┐┌┻┻┛穴┫穴穴穴
┣┗┻┻┻║┻┐┌┻┻║┻┐┗┛┌┻┻┻┛穴穴穴
穴┏┲┱┓穴穴┗┛穴穴穴穴┗┻┻┛穴穴穴穴穴穴穴
┳┳┣┫┫穴┌┻┻┻┻┻┻┻┻┻┻┐穴穴穴穴穴穴
┳┳┳┫┫穴┫┏┓穴穴穴穴穴穴穴穴┣穴穴穴穴穴穴
穴穴穴┫┫穴┫┗┛穴穴┏┳┳┳u┳┳穴穴穴穴穴穴
┻┻┌┫┫穴┫穴穴穴穴┣┏┲┱┓穴穴穴穴穴穴穴穴
┻┌┣┫┫┲┲┱┱u┳┳┣┣┫┫穴穴穴穴穴穴穴穴
穴┣┣┫┳┳┣┫┫穴穴穴┣┣┫┫穴穴穴穴穴穴穴穴
穴┣┣┐┻┻┌┫┫穴穴穴┣┗┛┫穴穴穴穴穴穴穴穴
穴┣┗┛穴穴┗┛┫穴穴穴┗┻┻┛穴穴穴穴穴穴穴穴
穴┗┻┻┻┻┻┻┛穴穴穴穴穴穴穴穴穴穴穴穴穴穴穴