树树树树树树树树水水树树树树树树土土树树树树树树树树树树树树树树树树树树树树树树水水树树树树树树稂草草草树稂稂树稂水树水树水水水水
树树树树树树树树水水树树树树树树土土树树树树树树树树树树树树树树树树树树树树树水水水树树树树树树树草稂树草草水树树水草水树水水水水
树树树树树树树树水水树树树树树树土土树树树树树树树树树树树树树树树树树树树树树水水水树树树树树树树树稂稂稂草草水草稂水树水水水水水
树树树树树树树树水水树树树树树树土土树树树树树树树树树树树树树树树树树树树树树水水树树树树树树树树树树树稂稂稂树稂水树树草树水仏土
树树树树树树树树水水水水水水水水橋橋水水水水水水水水水水水水水水树树树树树树树水水水树树树树树树树树树树稂草树树草稂水树土草水土土
树树树树树树树树水水水水水水水水橋橋水水水水水水水水飾飾飾飾水水树树树树树树树水水水树树树树树树树树树树稂草稂树草水水草稂草橋土飾
树树树树树垣道道道道道道道道道道道道道道道道道道道道無门無無水水水水水水水树树树水水水水树树树树树树树稂稂稂树草水草水水土土水飾飾
树树树树树垣道花土花土花土花土道道道道道道道道道道道道道飾飾水水水水水水水树树树树水水水水树树树稂稂稂树稂草草树水树水仏草树水無無
树树树树树垣道土飾飾飾飾飾飾花道道道飾飾飾道道石石石石飾道道飾石石石石水水树树树树树树水水水树树稂稂树树草稂草草水树水草土草稂無無
树树树树树垣道花飾飾飾飾飾飾土道道道無無無道道石仏土土飾飾飾飾李土树石水水树树树树树树树水水水树树草稂稂稂草稂树水水水水稂水水道道
树树树树树垣道土飾飾飾飾飾飾花道道道無無無道道石花土飾飾無無飾飾土草石水水树树树树树树树树水水水水草水稂稂水水水稂水水水水水水道道
树树树树树垣道花飾飾飾飾飾飾土道道道無無無道道石土土飾無無無無飾土土石水水树树树树树树树树树水水水水水稂水稂水草水草树草水水水水水
树树树树树垣道土無無無無無無花道道道無無無道道石土李無無门门無無仏土石水水树树树树树树树树树树树草草草稂草稂树水水草树草水水水水水
树树树树树垣道花無门学無無無土道道道無無無道道石树土土土道道土土土土石水水树树树树树树树树树树树草树树树水树水稂稂水草水水水水水水
树树树树飾飾飾土花土花土花土花道道無無门無無道石石石石石道道石石石石石水水树树树树树树树树稂稂稂稂水水稂水草水稂草水水水水水水水水
树树树树無無無道道道道道飾飾飾道道道道道道道道道道道道道道道道道道道道橋橋土土树树树树树树稂树树水稂树稂水稂水草草水水水水水水水水
树树树树树飾飾飾飾道道道無無飾飾道道道道道道道道道道道道道道道道道道道橋橋土土树树树树树树稂稂草树水稂树水稂水水草水水水水水水水水
树树树树树無無無無道道道道道無無道飾飾飾飾飾飾道飾飾飾道道道道飾飾飾飾水水土土树树树树树树水水稂稂草稂草水树树草飾飾飾飾水水水水水
道道道道道道道道道道道道道道道道道飾飾飾飾飾飾飾飾飾無道道道道飾飾飾飾水水土土树树树树树树树水水水水树草草草树無飾飾飾飾無水水水水
道道道道道道路路路路路路路道道道道無無無無無無無無無道道道道道無無無無水水土土树树树树树树树水水草水树水稂水水草無门無無水水水水树
道道道道道道路路路路路路路路道道道無無门競無無道道道土土土道道無门館無水水土土树树树树水树水树稂水稂树水稂草草草土土树水水水水树水
道道道道道道道道飾飾飾飾路路路道道道道道道道道道道土土水土道道道道道道水水土土树树树水草草水草稂水稂水草稂草草水草水水水水水树水树
树树树树树垣道道飾飾飾飾道路路路道道道道道道道土土土水水土道道道飾飾飾水水土土树水水稂树草水草树水树水草稂水草水水水水水水水树水树
树树树树树垣道道無無無無道道路路路道道道道道土土水华水水土道道道無無無水水土土草水水水树树水树水水水稂稂草水草水水水水水水水树树树
树树树树飾飾飾道無门買無道道道路路路道道道土土水水土水土土土道飾飾飾飾水水土草草草草水水水草水水树草水草水水草水水水水水水树水树草
树树树树無無無道道道道飾飾飾飾道路路路道道土水水树土华土树土道無门無無水水土土稂水稂稂稂水水水稂草草草草草草水水水水水水树水草稂稂
树树树树树垣道道道道道無無门無道道路路路道土水水水水水土土土道道道水水水水土树树水稂稂稂草草草草水水水水水水水水水水水树水稂稂树水
树树树树树垣道飾飾飾道道道道飾飾飾飾路路路土土水水土土土道道道道道水水土稂稂树水草稂稂树树草草草水草水水水水水水水水水水树稂草水水
树树树树树垣飾飾無無道飾飾飾飾無门無道路路路土土土土道道道水水水水水水稂土土土土水水树树树树水水草水水水水水水水水水水水水树稂稂稂
树树树树树垣無無道道道無無门無道道道道道路路飾飾飾道道飾飾水水水水水水水水水水水水水水水水水水水水水水水水水水水水水水水树水水草树
树树树树树垣道道道道道道道道道道道道道道路路無门無道道無無水水水水水水水水水水水水水水水水水水水水水水水水水水水水水水树水水树草树
树树树树树垣道道飾飾飾飾道道飾飾飾飾道道路路道道道道道道道道橋橋橋土土土土飾水水水水水水水水水水水水水水水水水水水水水树水水树水水
树树树树树垣道道無门無無飾飾飾飾無無道道路路道道道道道飾飾飾水水水土土土飾飾飾水水水水水水水水水水水水水水水水水水水水树水草草水水
树土土土土道道道道道道道無無门無道道道道路路飾飾飾道道無门無水水水土土飾飾無飾飾水水水水水水水水水水水水水水水水树树树水草稂树水树
树土土土土道飾飾飾飾道道道道道道道飾飾飾路路無無飾飾道道道水水水水土土飾無無無飾水水水水水水水水水水水水水水水树水水水草稂水水稂稂
树土土水水水無無飾飾飾飾水水水水水無無無路路道水無無飾飾飾飾水水水土土無無门無無水稂水水水水水水水水水水水水水树水水水水草水稂树草
树土土水水水土土無门無無水水水水水水水垣橋橋垣水水水無無無無水水水土土土土土土草水稂稂水水水水水水水水水水水水水水水水稂稂水树草树
树土土水水水土土土土土水水水水水水水水垣橋橋垣水水水水水水水水水水土土土土土土水稂水水水稂水水水水水水水稂稂水稂水稂稂稂树水草树树
树土土水水水水水水土土水水水水水水水水垣橋橋垣水水水水水水水水水水树稂草水稂树稂水草水草稂草水水水草草稂稂草稂草水水草草草水稂稂稂
树土土水水水水水水土土水水水水土土土土土道道土土土土水水水水水水水水草树水草水稂树草稂稂稂草水稂草草稂草水草水稂水草水树草稂水树草
土土土水水水水水水橋橋水水水水土土土土土道道土土土土树树树树树树树树树稂草草稂草稂草稂稂草草水水稂水水水水草水草水水水水水草水水草
土土土水水水水水水橋橋水水水水土土飾土土道道土土土土树树树树树树树树树树草水水水水水水水树稂草水草水水稂草水草草稂草水树草草树草草
树土土土土土土土土土土水水水水土飾飾飾土道道土土土土树树树树树树树树树树草稂树树草水水树树树稂稂水稂草稂稂水树稂草水草草草水树草树
