無無無無無無無無無無無無無無無無無無無無無無無無無無無
無無無無無無無無無無無無無無無無無無無無無無無無無無無
無無無無無無無無無無無無無無無無無無無無無無無無無無無
無無無無無無無無無無無無無無無無無無無無無無無無無無無
無無無寺寺寺寺寺寺寺寺寺寺寺寺寺寺寺寺無水水水水水水無
無無無寺寺寺寺寺寺寺寺寺寺寺寺寺寺寺寺無水水水水水水無
無無無寺寺無無無無無無寺寺無無無無寺寺無水水水水水水無
無無無寺寺無水水水水無寺寺無水水無寺寺無水水水水水水無
無無無寺寺無水水水水無寺寺無水水無寺寺無水水水水水水無
無無無寺寺無水水水水無寺寺無水水無寺寺無水水水水水水無
無無無寺寺無水水水水無寺寺無水水無寺寺無水水水水水水無
無無無寺寺無無無無無無寺寺無無無無寺寺無水水水水水水無
無無無寺寺寺寺寺寺寺寺寺寺寺寺寺寺寺寺無水水水水水水無
無無無寺寺寺寺寺寺寺寺寺寺寺寺寺寺寺寺無無無無無無無無
無無無無無無無寺寺無無無無無無無無寺寺寺寺寺寺寺寺寺無
無無無树土草無寺寺無水水水水水水無寺寺寺寺寺寺寺寺寺無
無無無树土土無寺寺無水水水水水砂無寺寺無無無寺無無無無
無無無稂稂土無寺寺無水水水水砂砂無寺寺無水無寺無水水無
無無無稂草土無寺寺無水水水砂砂砂無寺寺無水無寺無水水無
無無無树草土無寺寺無無無無無無無無寺寺無無無寺無水水無
無無無稂土土無寺寺寺寺寺寺寺寺寺寺寺寺寺寺寺寺無水水無
無無無稂土草無寺寺寺寺寺寺寺寺寺寺寺寺寺寺寺寺無水水無
無無無树草土無寺寺無無無無寺無無無無無無無寺寺無水水無
無無無稂土土無寺寺無寺寺無寺無水水水水水無寺寺無水水無
無無無树稂土無寺寺無寺寺無寺無水水水水水無寺寺無水水無
無無無無無無無無無無無無無门無無無無無無無無無無無無無
無無無無無無無無無無無無無無無無無無無無無無無無無無無