???????????????
???????????????
???????????????
???????????????
???????????????
???????????????
?_____________?
?_____________?
?_____________?
?_____________?
????_______????
????_______????
????_______????
???????^???????
???????????????