水水水水水水水水水水水水水水水水水水水水水水水水水水树┫树树树树树树树树树树树树树树树树树树树树树树树树树树
水水水水水水水水水水水水水水水水水水水水水水水水水水树┫树树树树树树树树树树树树树树树树树树树树树树树树树树
水水石石石石石石石石石石石石石石石石石石树树树树水水树┫树树树树树树树树树树树树树树树树树树树树树树树树树树
水水石石石石石石石石石石石石石石石石石┌┻┻┻┻滝滝┻┛树树树树树树树树树树树树树树树树树树树树树树树树树树
水水石石石石石石石石石石石石石石石石┌┛树树树树水水树树树树树树树树树树树树树树树树树树树树树树树树树树树树
水水石石石石石石石石石石石石石石石┌┛树树树树树水水树树树树树树树树树树树树树树树树树树树树树树树树树树树树
水水石石石石石┌┻┻┻┻┻┻┻┻┻┛树树树树树树水水树树树树树树树树树树树树树树树树树树树树树树树树树树树树
水水石石石石石┫水水水水水水水水水水水水水水水水水水水水水水水树树树树树树树树树树树树树树树树树树树树树树土
水水石石石石石┫水水水水水水水水水水水水水水水水水水水水水水水树树树树树树树树树树树树树树树树树树树飾飾飾飾
水水石石石石石┫水水無無無無無無無無無無無無無無無無無無無水水树树树树树树树树树树树树树树树树树树树飾飾飾飾
水水石石石石石┫水水無土土土土土土土土土土土土土土土土土無水水树树树树树树树树树树树树树树树树树树树無無無無
石石石石石石石┫水水無土水华水飾水水水土水水水飾水水水土無水水树树树树树树树树树树树树树树树树树树土無無门競
石石石石石石石┫水水無土水土飾飾飾土水土水土飾飾飾土水土無水水树树树树树树树树树树树树树树树树树土土道道道道
石石石石石石┌┛水水無土水飾飾無飾飾水土水飾飾無飾飾水土無水水树树树树树树树树树树树树树树树树土土土道道道道
石石石石石石┫树水水無土水飾無無無飾水土水飾無無無飾水土無水水水水水水水水水水水水水水水水水水水水水圯水水水
石石石石┌┻┛树水水無土水無無门無無水土水無無無無無水土無水水水水水水水水水水水水水水水水水水水水水圯水水水
石石石┌┛树树树水水無土水水水圯水水水土水水水圯水华水土無树树树树土土土土土土飾飾飾飾土土土土土道道道道道道
石┌┻┛树树树树水水無土土土土土土土土土土土土土土土土土無树树树树土土土土土土無门無無土土土土土道道道道道道
石┫树树树树树树水水無土無無無無土無無無無無土無無無無土無無树树树土土树树土土土土土土土土树树树道道飾飾飾飾
┌┛土土土土土土橋橋土土無水水無土無稂草树無土無水水無土土土土土土土土树树土土土土土土土土树树树道道飾飾飾飾
┫树土土土土土土橋橋土土無华水無土無土土稂無土無水水無土土土土土土土土树树树树树树树树树树树树树道道無無無無
┫树土土树树树树水水無土無無無無土無花無無無土無無無無土無無树树树树树树树树树树树树树树树树树树道道無無门学
┫树土土树树树树水水無土土土土土土土土土土土土土土土土土無树树树树树树树树树树树树树树树树树树树道道道道道道
┫树土土树树树树水水無土水水水飾水水水土水水水飾水水水土無树树树树树树树树树树树树树树树树树树树道道道道道道
┫树土土树树树树水水無土水土飾飾飾土华土水土飾飾飾土水土無树树┏┳┓树树树树树树树树树树树树树树树树道道树树
┫树土土树树树树水水無土水飾飾無飾飾水土水飾飾無飾飾水土無┏┲┲┱┱┓树树树树树树树树树树树树树树树道道树树
─土土土树树树树水水無土水飾無無無飾水土水飾無無無飾水土無┣┣┣┫┫┫树树树树树树树树树树树树树树树道道树树
─土土土树树树树水水無土水無無無無無水土水無無门無無水土無┣┣┣┫┫┳┓树树树树树树树树树树树树树树道道树树
┫树树树树树水水水水無土水水水圯水水水土水水水圯水水水土無┣┣┣┫┳┓┫树树树树树树树树树树树树树树道道树树
┳┳┳┳┳┓水水水水無土土土土土土土土土土土土土土土土土無┣┣┗┛穴┫┫树树树树树树树树树树树树树树道道树树
树树树树树┫水水树树無無無無無無無無無無無無無無無無無無無┣┣穴穴穴┫┫树树树树树树树树树树树树树树道道树树
水水水水树┫水水树树树树树树树树树树树树树树树┏┲┲┲┳┳┱┳┓穴┌┛┫树树树树树树树树树树树树树树道道树树
水水水水树┫水水树树树树树树树树树树树树树树树┣┣┣┗┐穴┫穴┫┌┛┌┛树树树树树树树树树树树树树树道道树树
┌┻滝滝┻┛水水树树树树树树树树树树树树树树树┣┣┗┐┣┌┛┌┛┫┌┛树树树树树树树树树树树树树树树道道树树
┫树水水水水水水树树树树树树树树树树树树树树树┣┗┐┣┗┛┌┛┌┛┫树树树树树树树树树树树树树树树树道道树树
┫树水水水水水水树树树树树树树树树树树树树树树┗┐┣┗┻┻┛┌┛┌┛树树树树树树树树树树树树树树树树道道树树
