無無無無無無無無無無無無無無無無無無無無無無無無無無無
無無道道道道道道道道道道無草草草草草草草草草草草草草無
無無道道道無無無無道道道無稂草草稂無無無無無無無無门無
無無道道道道道道道道道道無草稂草草無草草草草稂草草草無
無無道道道道道道道道道道無草草草草無草草草草草草草草無
無無道道無無道道無無道道無草草草草無草草稂草草草草稂無
無無道道道道道道道道道道無草稂草草無稂草草草稂草草草無
無無道道無無道道無無道道無草草草稂無草稂草草草草稂草無
無無道道道道道道道道道道無草草草草無草草草草草草草草無
無無道道無無道道無無道道無草草稂草無無無無無無無無门無
無無道道道道道道道道道道無稂草草草草稂草草草草草無道道
無無無無無無门门無無無無無無無無無無無無無無無無無道無
無無道道道道道道道道道道道道门道道道道道道道道道道道無
無無道道道道道道道道道道道道無道道道無無無無道道道無無
無無道道道道道道道道道道道道無道道道道道道道道道道無無
無無道道道無無無無無無道道道無道道道道道道道道道道無無
無無道道道無土土李土無道道道無道道無無道道無無道道無無
無無道道道無土李土土無道道道無道道道道道道道道道道無無
無無道道道门土土土土门道道道無道道無無道道無無道道無無
無無道道道無土土土李無道道道無道道道道道道道道道道無無
無無道道道無李土土土無道道道無道道無無道道無無道道無無
無無道道道無無無無無無道道道無道道道道道道道道道道無無
無無道道道道道道道道道道道道無無無無無门门無無無無無無
無無道道道道道道道道道道道道道道道道道道道道道道無無無
無無道道道道道道道道道道道道道道道道道道道道道道無無無
無無無無無無無無無無無無無门無無無無無無無無無無無無無
無無無無無無無無無無無無無無無無無無無無無無無無無無無