無無無無無無無無無無無無無無無無無無無無無無無無無無無
無無無無無無無無無無無無無無無無無無無無無無無無無無無
無無無無無無無無無無無無無無無無無無無無無無無無無無無
無無無無無無無無無無無無無無無無無無無無無無無無無無無
無無無無無無無無無無無無無無無無無無無無無無無無無無無
無無無無無無無無無無無無無無無無無無無無無無無無無無無
無無無無無無無無無無無無無無無無無無無無無無無無無無無
無無無無無無無無無無無無無無無無無無無無無無無無無無無
無無無無無無無無無無無無無無無無無無無無無無無無無無無
無無無無無無無無無無無無無無無無無無無無無無無無無無無
無無無無無無無無無無無無無無無無無無無無無無無無無無無
無無無無無無無無無無無無無無無無無無無無無無無無無無無
無無無無無無無無無無無無無無無無無無無無無無無無無無無
無無無無無無無無無無無無無無無無無無無無無無無無無無無
無無無無無無無無無無無無無無無無無無無無無無無無無無無
無無無無無無無寺寺寺寺寺寺寺寺寺寺寺寺寺無無無無無無無
無無無無無無無路路路路路路路路路路路路路無無無無無無無
無無無無無無無寺寺寺寺寺寺寺寺寺寺寺寺寺無無無無無無無
無無無無無無無寺寺寺寺寺寺寺寺寺寺寺寺寺無無無無無無無
無無無無無無無無無無门無無寺寺寺寺寺寺寺無無無無無無無
無無無無無無無寺寺寺寺寺無無無無门無無無無無無無無無無
無無無無無無無寺寺寺寺寺無寺寺寺寺寺寺寺無無無無無無無
無無無無無無無寺寺寺寺寺無寺寺寺寺寺寺寺無無無無無無無
無無無無無無無寺寺寺寺無無無寺寺寺寺寺寺無無無無無無無
無無無無無無無寺寺寺寺無寺無寺寺寺寺寺寺無無無無無無無
無無無無無無無無無無门無無無無無门無無無無無無無無無無
無無無無無無無無無無無無無無無無無無無無無無無無無無無