树树树石石石树树树树树树树树树树树土土草草土土草草草草土土树树树树树树树树树树树树树树树树树树土土土土土土树树树树树树树树道道道道飾飾飾飾树树树树
树树树石石石石石石石树树树树树树树草草草草草草草草土土土土树树树树树树树树树树树树树树树树树树土土树树树树树树树树树树树树無道無無飾飾飾飾树树树树
树树石石石石石石石石石石石石树树树草草草草草草草草土土土土树树树树树树树树树树树树树树树树树树土土树树树树树树树树树树树树道道道道無無無無树树树树
树树石石石石石石石石石石石石石石石石石树树稂稂树树树树树树树树树树树树树树树树树树树树树树树树土土树树树树树树树树树树树树道道道道無门無無土土树树
树树石石石石石石石石石石石石石石石石石树树稂稂树树树树树树树树树树树树树树树树树树树树树树树树土土树树树树树树树树树树树树道道道道道道道道道道道树
树树石石石石石石石石石石石石石石石石石石石稂稂树树树树树树树树树树树树树树树树树树树树树树树树土土土土树树树树飾飾飾飾土土道道道道道道道道道道道树
树石石石石石石石石石石石石石石石石石石石石稂稂石石石石石石石石石石石石石石石树树树树树树树树树土土土土树树树树飾飾飾飾土花道道道道土花土花土道道树
树石石石石石石石石石石石石石石石石石石石石稂稂石石石石石石石石石石石石石石石树树树树树树树树树土土土土树树树树無门無無花土道道道道花土花土花道道树
树石石石石石石石石石石石石石石石石石石石石稂稂石石石石石石石石石石石石石石石树無树树树树树树树土土土土树树树树道道道道道道道道道道土土土土標道道树
树石石石石石石石石石石石石石石石石石石石石稂稂飾飾飾飾石石石石石石石石石石石树树树树树树树树树树树土土树树树树道道道道道道道道道道土土土土土道道树
石石石石石石石石石石石石石石石石石石石石石草草無门無無石石石石石石石石石石石树树树树树树树树树树树土土树树树树树树树树树树树树土土土土土土土道道道
石石石石石石石石石石石石石石石石石石石石石草草土土土土土石石石石草草草草土土土草草草草草土土土土土土土树树树树树树树树树树树树土土土土土土土道道道
石石石石石石石石石石石石石石石石石石石石石草草土土土土土石石石石草草草草土土土草草草草草土土土土土土土树树树树树树树飾飾飾飾树树树树树树树树树树树
石石石石石石石石石石石石石石石石石石石石石草草石石石草草石石石石石石草草石石树树树树树树树土土土土土土土土树树树树树無门無無树树树树树树树树树树树
石石石石石石石石石石石石石石石石石石石石石草草石石石草草石石石石石石草草石石树树树树树树树土飾土土土土土土树树树树树土土土土树树树树树树树树树树树
石石石石石石石石石石石石石石石石石石石石石土土石石石稂稂稂稂草草石石草草石石树树树石石石石石石石石树树土土树树树树树土土土土土树树树树树树树树树树
石石石石石石石石石石石石石石石石石石石石石土土石石石稂稂稂稂草草石石草草石石树树树石石石石石石石石树树土土树树树树树树树土树树树树树树树树石石石石
石石石石石石石石石石石石石石石石石入石石石土土石石石石石石石草草石石草草石石树树树飾飾飾飾石石石石石石土土树树树树树树树土树树树树树树树树石石石石
石石石石石石石石石石石石石石石石石草草石石土土石石石石石石石草草土花土花石石树树树無门無無石石石石石石土土树树树土土土土土树树树树树树树树石石石石
石石石石石石石石石石石石石石石石石草草石石土土草草稂稂石石石草草花土花土石石树树树道道道道石石石石石石土土土土土土树树树树树树树树树树树石石石石石
石石石石石石石石石石石石石石石石石草草石石土土草草稂稂石石石石石石石石石石石树树树道道道道石石石石石石土土树树树树树树树树树树树树树树树石石石石石
石石石石石石石石石石石石石石石石石稂稂石石石石石石草草石石石石石石石石石石石树树树树树道道道道土土土無土土树树树树树树树树树树树树树树石石石石石石
石石石石石石石石石石石石石石石石石稂稂石石石石石石草草石石石石石石石石石石石树树树树树道道道道土土土無土土树树树树树树树树树树树树树树石石石石石石
石石石石石石石石石石石石石石石石石稂稂草草飾飾飾飾稂稂石石石石石石石石石石石树树树树树道道石石石石土無草草树树树树树树树树树树树树树树石石石石石石
石石石石石石石石石石石石石石石石石稂稂草草無门無無稂稂石石土土土石石石石石树树树树树树道道石石石石無無草草树树树树树树树树树树树树树石石石石石石石
石石石石石石石石石石石石石石石石石石石土土土土土土草草土土土果土石石石石树树树树树树树土土石石石石草草草草树树树树树树树树树树树树树石石石石石石石
树石石石石石石石石石石石石石石石石石石土土土土土土草草土土土土土石石石石树树树树树树树土土石石石石草草草草树树树树树树树树树树树树石石石石石石石石
树石石石石石石石石石石入石石石石石石石石石石石石石石石石石石石石石石石石树树树树树树树土土石石石石土土草草树树树树树树树树树树树树石石石石石石石石
树石石石石石石石石石石土土石石石石石石石石石石石石石石石石石石石树树树树树树树树树树树树土石石石石土土草草树树树树树树树树树树树树石石石石石石石石
树树石石石石石石石石石土土石石石石石石石石石石石石石石石石石石树树树树树树树树树树树树土土草草草草草草树树树树树树树树树树树树树石石石石石石石石石
树树石石石石石石石树树土土树树树树树树树树树树石石石石石石树树树树树树树树树树树树树树土土草草草草草草树树树树树树树树树树树树树石石石石石石石石石
树树石石石石石石石树树土土树树树树树树树树树树石石石石石石树树树树树树树树树树树树树树草草土土草草树树树树树树树树树树树树树树石石石石石石石石石石
树树树石石石石石石树树花李花花花花花李花花树树石石石石石石树树树树树树树树树树树树树树草草土土草草树树树树树树树树树树树树树树石石石石石石石石石石
树树树石石石石石石树树花花李花李花花花花花树树石石石石石石树树树树树树树树树树树树花土花土道道树树石石石石树树树树树树树树树树树石石石石石石石石石
树树树树树石石石石树树花花水水水水水水花李树树石石石石石石树树树树树树树树树花土花土花土花道道树树石石石石树树树树树树树树树树树石石石石石石石石石
树树树树树石石石石树树李花水华水水华水花花树树石入石石石石树树树树树树树树草草石石石石石石道道石石石石石石树树树树树树树树树树树树石石石石石石石石
树树树树树石石石石树树花花水水水水水水花花树树土土土石石石树树树树树树树树草草石石石石石石道道石石石石石石树树树树树树树树树树树树树石石石石石石石
树树树树树石石石石树树花李花花李花花李花花土土土果土石石石树树树树树树草草草草石石石石石石道道石石石石石石树树树树树树树树树树树树树石石石石石石石
树树树树树石石石石树树花花花花花花花花花花土土土土土石石石树树树树树树草草草草石石石石石石道道石石石石石石树树树树树树树树树树树树树树石石石石石石
树树树树树石石石石树树树树树树树树树树树树树树石石石石石石树树树树树树草草草草石石石石土花道道石石石石石石树树树树树树树树树树树树树树石石石石石石
树树树树树石石石石树树树树树树树树树树树树树树石石石石石石树树树树树树草草草草石石石石花土道道石石石石石石树树树树树树树树树树树树树树树石石石石石
树树树树树石石石石石石石石石石石石石石石石石石石石石石石石树树树树树树草草草草草草道道道道道道石石石石石石树树树树树树树树树树树树树树树树石石石石
树树树树树石石石石石石石石石石石石石石石石石石石石石石石石树树树树树树草草草草草草道道道道道道石石石石石石树树树树树树树树树树树树树树树树石石石石
树树树树树石石石石石石石石石石石石石石石石石石石石石石树树道道道道道道道道道道道道道道石石石石石石石石石石树树树树树树树树树树树树树树树树树石石石
树树树树树石石石石石石石石石石石石石石石石石石石石石石树树道道道道道道道道道道道道道道石石石石石石石石石石树树树树树树树树树树树树树树树树石石石石
树树树树树树树树树树树树树树树树树树树树树树树树树树树树树道道土土石石石石石石石石石石石石石石石石石石石石树树树树树树树树树树树树树树树树石石石石
树树树树树树树树树树树树树树树树树树树树树树树树树树树树树道道李土石石石石石石石石石石石石石石石石石石石石树树树树树树树树树树树树树树树石石石石石
树树树树树树树树树树树树树树树树树树树树树树树树树树树树树道道土土石石石石石石石石石石石石石石石石石石石石树树树树树树树树树树树树树树树石石石石石
树树树树树树树树树树树树树树树树树树树树树树树石石树树树树道道土李石石石石石石石石石石石石石石石石石石石石树树树树树树树树树树树树树树石石石石石石
树树树树树树树树树树树土土土土树树石石树飾飾飾飾树飾飾飾飾道道树树石石石石石石石石石石石石石石石石石石石石石石石石石石树树树树树树树树石石石石石石
树树树树树树树树树树树土土土土树树石石土無门無無土飾飾飾飾道道树树石石石石石石石石石石石石石石石石石石石石石石石石石石树树树树树树树石石石石石石石
树树树树树树树树树树树土土飾飾飾飾树树土土道道道道無無無無道道石石石石石石石石石石石石石石石树树树树树石石石石石石石石树树树树树树树石石石石石石石
石石树树树树石石石树树土土無门無無树树土土道道道道無门無無道道石石石石石石石石石石石石石石石树树树树树石石石石石石石石树树树树树树石石石石石石石石
草草草草草土土石石树树土土道道花花树树飾飾飾飾道道道道道道道道树树石石石石石石石石石石石石石树树树树树石石石石石石石石树树树树树树石石石石石石石石
草草草草草土土石石树树無無無道無無树树飾飾飾飾道道道道道道道道树树石石石入石石石石石石石石石树树树树树石石石石石石石石树树树树树石石石石石石石石石
树石石石石土土石石树树土土道道土土树树無無無無土土道道道道土土土土土土土土土土树树树树树树树树树树树树石石石石石石石石石石树树树石石石石石石石石石
树石石石石土土標石树树土土道道土土树树無门無無土標道道道道土土土土土土土土土土树树树树树树树树树树树树石石石入石石石石石石树树石石石石石石石石石石
石石石石石土土土土土土道道道道道道道道道道道道道道道道道道土土土土土土土土土土树树树树树树树树树树土土無土土土土土石石石石石石石石石石石石石石石石
石树树树树土土土土土土道道道道道道道道道道道道道道道道道道树树树树無無無土無無树树树树树树树树土土土土無土土土土土石石石石石石石石石石石石石石石石
树树树树树树树树树树树道道飾飾飾飾飾飾土花道道花土飾飾飾飾树树树树花土花土土土树树树树树树石石土土土土無土土土土土石石石石石石石石石石石石石石石石
树树树树树树树树树树树道道飾飾飾飾飾飾花土道道土花無门無無树树树树土花道道土土树树树树树树石石土土土土無無無無無道石石石石石石石石石石石石石石石石
树树树树树树树树树树树道道無無無無無無土花道道道道道道道道石石飾飾飾飾道道土土树树树树树树土土土土土土土土土土土土土土石石石石石石石石石石石石石石
树树树树树树树树树树树道道無無门無無無花土道道道道道道道道石石無门無無道道土土树树树树树树土土土土土土土土土土土土土土石石石石石石石石石石石石石石
石石树树树树树树树树树道道道道道道道道道道道道花土树树石石道道道道道道道道树树树树树树树树树树树树草草草草草草土土土土石石石石石石石石石石石石石石
石石石石树树树树树树树道道道道道道道道道道道道土花树树石石道道道道道道道道树树树树树树树树树树树树草草草草草草土土土土石石石石石石石石石石石石石石
石石石石石石树树树树树树树树树树树树树树树树树树树树树树树树树树树树树树树树树树树树树树树树树树树树树树树树树树树树树树石石石石石石石石石石石石石
石石石石石石石石树树树树树树树树树树树树树树树树树树树树树树树树树树树树树树树树树树树树树树树树树树树树树树树树树树树树石石石石石石石石石石石石石
石石石石石石石石石石树树树树树树树树树树树树树树树树树树树树树树树树树树树树树树树树树树树树树树树树树树树树树树树树树树石石石石石石石石石石石石石
石石石石石石石石石树树树树树树树树树树树树树树树树树树树树树树树树树树树树树树树树树树树树树树树树树树树树树树树树树树树石石石石石石石石石石石石石
石石石石石石石石石树树树树树树树树树树树树树树树树树树树树树树树树树树树树树树树树树树树树树树树树树树树树树树树树树树树石石石石石石石石石石石石石
石石石石石石石石树树树树树树树树树树树树树树树树树树树树树树树树树树树树树树树树树树树树树树树树树树树树树树树树树树树树石石石石石石石石石石石石石
树树树树树树树树树树树树树树树树树树树树树树树树树树树树树树树树树树树树树树树树树树树树树树树树树树树树树树树树树树树树石石石石石石石石石石石石石
树树树树树树树树树树树树树树树树树树树树树树树树树树树树树树树树树树树树树树树树树树树树树树树树树树树树树树树树树树树树石石石石石石石石石石石石石
树树树树树树树树树树树树树树树树树树树树树树树树树树树树树树树树树树树树树树树树树树树树树树树树树树树树树树树树树树树树石石石石石石石石石石石石石
树树树树树树树树树树树树树树树树树树树树树树树树树树树树树树树树树树树树树树树树树树树树树树树树树树树树树树树树树树树树石石石石石石石石石石石石石
树树树树树树树树树树树树树树树树树树树树树树树树树树树树树树树树树树树树树树树树树树树树树树树树树树树树树树树树树树树树石石石石石石石石石石石石石
树树树树树树树树树树树树树树树树树树树树树树树树树树树树树树树树树树树树树树树树树树树树树树树树树树树树树树树树树树树树石石石石石石石石石石石石石
树树树树树树树树树树树树树树树树树树树树树树树树树树树树树树树树树树树树树树树树树树树树树树树树树树树树树树树树树树树树石石石石石石石石石石石石石
树树树树树树树树树树树树树树树树树树树树树树树树树树树树树树树树树树树树树树树树树树树树树树树树树树树树树树树树树树树树石石石石石石石石石石石石石
树树树树树树树树树树树树树树树树树树树树树树树树树树树树树树树树树树树树树树树树树树树树树树树树树树树树树树树树树树树树石石石石石石石石石石石石石
树树树树树树树树树树树树树树树树树树树树树树树树树树树树树树树树树树树树树树树树树树树树树树树树树树树树树树树树树树树树石石石石石石石石石石石石石
树树树树树树树树树树树树树树树树树树树树树树树树树树树树树树树树树树树树树树树树树树树树树树树树树树树树树树树树树树树树石石石石石石石石石石石石石
树树树树树树树树树树树树树树树树树树树树树树树树树树树树树树树树树树树树树树树树树树树树树树树树树树树树树树树树树树树树石石石石石石石石石石石石石
树树树树树树树树树树树树树树树树树树树树树树树树树树树树树树树树树树树树树树树树树树树树树树树树树树树树树树树树树树树石石石石石石石石石石石石石石
树树树树树树树树树树树树树树树树树树树树树树树树树树树树树树树树树树树树树树树树树树树树树树树树树树树树树树树树树树树石石石石石石石石石石石石石石
树树树树树树树树树树树树树树树树树树树树树树树树树树树树树树树树树树树树树树树树树树树树树树树树树树树树树树树树树树石石石石石石石石石石石石石石石