┳┳┓树树树树树树树树土土土树树畑畑畑畑畑畑畑树树树树树树树土土水水树树树树树树树树水水水水水水水树树树┣┣┏┳┳┳┳┳┳┳┳┓┫┫树
┳┓┫树树树树树树树树土树土树树畑畑畑畑畑畑畑树树树树树树树土土水水树树树树树树树树水水水水水水水树树树┣┣┣┏┳┳┳┳┳┳┓┫┫┫树
穴┫┫树树树树树树树树土土土土土畑畑畑畑畑畑畑树树树树树树树土土水水树树树树树树树树树树树树树树树树树树┣┣┣┗入┻┻┻┻┐┫┫┫┳┳
穴┫┳┳┳┳┓树树树树树树树树树畑畑畑畑畑畑畑树树树树树树树土土水水树树树树树树树树树树树树树树树树树树┣┣┣穴穴穴穴穴穴┣┫┫┳┳┓
┳┳┳┳┳┓┫树树树树树树树树树畑畑畑畑畑畑畑树树树树树水水圯水水水土土树树树树草树树树树树树树树树树树┣┣┗┻┻┻┻┐穴┣┫┳┓穴┫
穴穴穴穴穴┫┫树树树树树树树树树畑畑畑畑畑畑畑树树树树树水水圯水水水树土土树树树草草树草树树树树树树树树┣┣穴┏┳┓穴┣穴┣┳┓┫穴┳
穴穴穴穴穴┫┫树树树树树树树树树土土飾飾飾土土树树树树树水水土树土树土树草草草树草草草草树树树树树树树树┣┣穴┗┐┫穴┣穴┗┐┫┫穴穴
穴穴穴穴穴┫┫树树树树树树树树树树土無门無土树树树树树树水水土土土土土土草树草草草草草草树树树树树树树树┣┣穴穴┗┛穴┗║┐┣┫┫穴穴
穴穴穴穴穴┫┫树树树树树树树树树树土土土土土树土土土土土橋橋土土树土土树草草土土土土土土树树树树树树树树┣┗┐穴穴穴穴穴穴┣┣┫┫穴穴
穴穴穴穴穴┫┫树树树树树树树树树树土树树树树树土树树树树水水树土土土土土树草树土树土土土树树树树树树树树┣穴═穴岩穴岩穴穴┣┗┛┫穴穴
穴穴穴穴穴┳┳┳┳┳┱┳┓树树树树土土土土树树土树树树树水水畑畑畑畑土土土土土土畑畑土土草草草草草草树树┣穴┗┐穴穴穴穴岩┗┻┻┛穴穴
穴穴┏┳┳┳┳┳┳┱┳┱┳┱┳┓树树树树土树树土树树树树水水畑畑畑畑土土土土土土畑畑土土草草草草草草树树┣穴穴┣穴岩穴穴穴┌┻┻┻┻┻
穴穴┣┏┲┳┳┳┓┫穴┫穴┫穴─土土土土土土土土树树树树水水畑畑畑畑畑畑畑畑畑畑畑畑土土草草草草草草草草═穴穴┣穴穴穴岩┌┛穴穴穴穴穴
穴穴┣┣┣┌┻┻┛┫穴─穴┫穴┫树树树树树树树树树树树树水水畑畑畑畑畑畑畑畑畑畑畑畑土土草草草草草草草草═穴穴┗┻┻┻┻┛穴穴穴穴穴穴
穴穴┣┣┗┛┌┻入┛穴┫穴┫穴┫树树树树树树树树树树树树水水畑畑畑畑畑畑畑畑畑畑畑畑土土草草树树树树树树┣┏┳┳┳┳┳┳┳┳┳┓穴穴穴
穴穴┣┗┻┻┛穴穴穴穴┫穴┫穴┫树树树树树树树树树树树树水水畑畑畑畑畑畑畑畑畑畑畑畑土土草草树树树树树树┣┣┏┳┳┳┳┳┳┳┓┫穴穴穴
穴穴┗┻┻┻┻┐┌┻┻┛穴┫穴┫树树树树树树树树树树树树水水畑畑畑畑土土土土土土畑畑土土树树树树树树树┏┳┣┣穴穴穴穴穴穴穴┫┫穴穴穴
┏┳┳┳┳┳┓┗┛穴穴穴穴┫穴┫树树树树树树树树树树树树水水飾飾飾飾土土土土土土畑畑土土树树树树树树树┣穴┣┗┻┻┻┻┻┻┻┛┫穴穴穴
┗┻┻┻┻┻┛穴┌║┻┻┻┛穴┫树树树树树树树树树树树树水水無门無無土土树树土土土土土土树树树树树树┏┳穴┗┻┻┻┻┻┻┻┻┻┛穴穴穴
穴穴┌入┐穴┌┻┛穴穴穴穴穴穴┫树树树树树树树树树树树树水水土土土土土土树树土土土土土土树树树树树┏┳穴穴穴穴穴穴穴穴穴穴穴穴穴穴穴穴
┌┻┛穴┗┐┫┌┻┻┻┻┻┻┻┛树树树树树树树树树树树树水水土土土土土土树树树树树树树树树树树树┏┳穴穴穴穴穴穴穴穴穴穴穴穴穴穴穴穴穴
┛穴穴穴穴┗┛┫树树树树树树树树树树树树树树树树树树树水水水土土树树树树树树树树树树树树树树树树┣穴穴穴穴穴穴穴穴穴穴穴穴穴穴穴穴树树
穴穴穴穴穴穴穴┫树树树树树树树树树树树树树树树树树树水水水水土土树树树树树树树树树树树树树树树┏┳穴穴穴穴穴穴穴穴穴穴穴穴穴树树树树树
穴┏┳┓穴穴穴┫树树树树树树树树树树树树树树树树树水水水水土土土树树树树树树树树树树树树树树┏┳穴穴穴穴穴穴穴穴穴穴穴树树树树树树树树
┳┳穴┳┳┳┓┫树树树树树树树树树树树树树树树树水水水水土土土土树树树树树树树树树树树树树┏┳穴穴穴穴穴穴穴穴树树树树树树树树树树树树
穴穴穴穴穴穴┫┫畑畑畑社畑畑畑树树树树树树树树水水水水土土土土土土树树树树树树树树树树树树┣穴穴穴穴穴穴穴穴树树树树树树树树树树树树树
┳┳┓穴穴┌┛┫畑畑畑畑畑畑畑树树树树树树树水水水水土土土土土土土草树树树树树树树树树树┏┳穴穴穴穴穴穴穴树树树树树树树树树树树树树树
穴穴┫穴┌┛┌┛畑畑畑畑畑畑畑树树树树树树水水水草草土土土土土土土草树树树树树树树树树树┣穴穴穴穴穴穴穴穴树树树树树树树树树树树树树树
穴穴┫┌┛┌┛树畑畑畑畑畑畑畑飾飾飾飾水水水水草草土土土土土土土树草草树树树树树树树树树┣穴穴穴穴穴穴穴树树树树树树树树树树树树树树树
穴穴┫┫┌┛树树畑畑畑畑畑畑畑無门無無水水水草草土土土土树土土土土土草树树树树树树树树树┣穴穴穴穴穴穴穴树树树树树树树树树树树树树树树
┌┻┛┫┫树树树畑畑畑畑畑畑畑土土土土水水水草草土土土土土土土土土土草树树树树树树树树树┣穴穴穴穴穴穴穴穴穴穴穴穴穴穴穴穴穴穴穴穴穴穴
┛┌入┛┫树草草畑畑畑畑畑畑畑土土土土水水草草草土土土土土土土土土土草树树树树树树树树树┣穴穴穴穴穴穴穴穴穴穴穴穴穴穴穴穴穴穴穴穴穴穴
┌┛穴┌┛树草树树树树树树树树土土土土橋橋土土土土土飾飾飾飾土土土土草树树树树树树树树树┣穴穴穴穴穴穴穴穴穴穴穴穴穴穴穴穴穴穴穴穴穴穴
┛穴穴┫树树草树树树树树树树树土土土土橋橋土土土土土無门無無土土土土树树树树树树树树树┏┳穴穴穴穴穴穴穴穴穴穴穴穴穴穴穴穴穴穴穴穴穴穴
穴穴┌┛树树草草草树树树树树树树树土土水水土土土树土土土土土土土土土树树树树树树树树树┣穴穴穴穴穴穴穴穴穴穴穴穴穴穴穴穴穴穴穴穴┌┻┻
┌║┛土花树水水草树树树树树树树树树树水水水土土土土土土土土土土土土草树树树树树树树树┣┏┳┳┳┳┳┳┳┳┳┳┳┳┳┳┳┳┳┳┓┫水水
┛土土土土土水水草树树树树树树树树树树水水水土土土土土土土土土土土土草树树树树树树树树┣┣穴穴穴穴穴穴穴穴穴穴穴穴穴穴穴穴穴穴┫┫水水
李土树土李土草草草树树树树树树树树树树水水水草土土土土土土土土土土树树树树树树树树树树┣┣穴穴穴穴穴穴穴穴穴穴穴穴穴穴穴穴穴穴┳┳┱┓
树土土土树土树树树树树树树树树树树树树水水水草草土土树土土土土土土树树树树树树树树树树┣┣穴穴穴穴穴穴穴穴穴穴穴穴穴穴穴穴穴穴穴穴┫┫
树树树土土树树树树树树树树树树树树树树树水水草草草土土土土土土树土草树树树树树树树树树┣┣穴穴穴穴穴穴树树树穴穴穴穴穴穴穴穴穴穴穴┫┫
树树树树树树树树树树树树树树树树树树树树水水水草草草土土土土土草草草树树树树树树树树树┣┣穴穴穴穴穴树树树树树树树穴穴穴穴穴穴穴穴┫┫
树树树树树树树树树树树树树树树树树树树树水水水水草草土土土土土草树树树树树树树树树树树┣┣穴穴穴穴树树树树树树树树树树穴穴穴穴穴穴┳┳
树树树树树树树树树树树树树树树树树树树树水水水水水草草土土土土草树树树树树树树树树树树┣┣穴穴穴穴树树树树树树树树树树树树穴穴穴穴穴穴
树树树树树树树树树树树树树树树树树树树树树树水水水水草草土土土树树树树树树树树树树树树┣┣穴穴穴穴树树树树树树树树树树树树树树穴穴穴穴
树树树树树树树树树树树树树树树树树树树稂稂稂树水水水水草草土土树树树树树树树树树树树树┣┣穴穴穴穴树树树树树树树树树树树树树树树穴穴穴
树树树树树树树树树树树树树树树树树稂树稂树稂稂稂水水水水草土土树树树树树树树树树树树┏┳┣穴穴穴穴树树树树树树树树树树树树树树树树树穴
畑畑土畑畑畑树树树树树树树树树树树稂稂稂稂树稂树树水水水水土土树树树树树树树树树树树┣┏┳穴穴穴穴树树树树树树树树树树树树树树树树树树
畑畑土畑畑畑树树树树树树树树树树树树稂稂稂稂飾树树稂水水水土土树树树树树树树树树树树┣┣穴穴穴穴穴穴树树树树树树树树树树树树树树树树树
畑畑土畑畑畑树树树树树树树树树树树稂稂稂树飾飾飾稂稂水水水土土树树树树树树树树树树树┣┣穴穴穴穴穴穴穴穴树树树树树树树树树树树树树树树
土土土土土土树树树树树树树树树稂稂稂树稂飾飾飾飾飾土土道道土土稂稂稂稂树树树树树树树┣┗┐穴穴穴穴穴穴穴穴穴穴树树树树树树树树树树树树
畑畑土畑畑畑树树树树树树树树树树稂树稂稂無無無無無土土道道土土稂树稂稂树树树树树树树┗┐┗┐穴穴穴穴穴穴穴穴穴穴穴穴穴穴穴穴穴穴穴穴穴
畑畑土畑畑畑树树树树树树树树树树树稂稂稂無無门無無土土水水稂稂稂稂稂树树树树树树树树树┗┐┗┻┐穴穴穴穴穴穴穴穴穴穴穴穴穴穴穴穴穴穴穴
畑畑土畑畑畑树树树树树树树树树树树稂树稂稂土土土土土土水水树稂稂树稂稂树树树树树树树树树┗┻┐┗┐穴穴穴穴穴穴穴穴穴穴穴穴穴穴穴穴穴穴
树树树树树树树树树树树树树树树树稂稂稂稂稂土土土土土土水水稂稂稂稂稂稂树树树树树树树树树树树┗┐┗┐穴穴穴穴穴穴穴穴穴穴穴穴穴穴穴穴穴
树树树树树树树树树树树树树树稂稂稂树稂树稂稂树树树土土水水稂树稂树稂树树树树树树树树树树树树树┗┐┗┻┐穴穴穴穴穴穴穴穴穴穴穴穴穴穴穴
树树树树树树树树树树树树树树稂树树树树树树稂树树树土土道道土土稂稂树树树树树树树树树树树树树树树┗┻┐┗┐穴穴穴穴穴穴穴穴穴穴┌┻┻┻
树树树树树树树树树树树树树树树树树树树树树树树树树土土道道土土稂树树树树树树树树树树树树树树树树树树┗┐┗┐穴┌┻┻┻┐穴穴穴┫┌┻┻
树树树树树树树树树树树树树树树树树树树树树树树树树水水水水土土树树树树树树树树树树树树树树树树树树树树┗┐┗┐┫┌入┐┗┻┻┻┛┫水水
树树树树树树树树树树树树树树树树树树树树树树树树树水水水水土土树树树树树树树树树树树树树树树树树树树树树┗┐┗┛┫穴┗┻┻┻┻┻┛水水
树树树树树树树树树树树树树树树树树树树树树树树树水水水水树土土树树树树树树树树树树树树树树树树树树树树树树┗┻┐┫穴穴穴穴穴穴穴穴滝滝
树树树树树树树树树树树树树树树树树树树树树树树水水水水树树土土树树树树树树树树树树树树树树树树树树树树树树树树┣┳┳┳┓水水水水水水水
树树树树树树树树树树树树树树树树树树树树树树水水水水水树树土土树树树树树树树树树树树树树树树树树树树树树树树树┗┻┻┻┛水水水水水水水
树树树树树树树树树树树树树树树树树树树树树水水水水水树树树土土树树树树树树树树树树树树树树树树树树树树水水水水水水水水水水水┏┲┳┳┳
畑树树树树树树树树树树树树树树树树树树树树水水水水树树树树土土树树树树树树树树树树树树树树树树树树树树水水水水水水水水水水水┣┣穴穴穴
畑树树树树树树树树树树树树树树树树树树树水水水水树树树树树土土树树树树树树树树树树树树树树树树树树树树水水树树树树树树树┏┲┳┳穴穴穴
畑树树树树树树树树树树树树树树树树水水水水水水水树树树树树土土树树树树树树树树树树树树树树树水水水水水水水树树树树树树树┣┣穴穴穴穴穴
畑树树树树树树树树树树树树树树树树水水水水水水树树树树树树土土树树树树树树树树树树树树树树树水水水水水水水树树树树树树树┣┣穴穴穴穴穴
畑树树树树树树树树树树树树树树树树水水水土土土土土土土土土土土树树树树树树树树树树树树树树树水水飾飾飾飾树树树树树树树树┣┣穴穴穴穴穴
畑树树树树树树树树树树树树树树树树水水水土土土土土土土土土土土树树树树树树树树树树树树树树树水水無门無無树树树树树树树树┣┣┌┻┻┻┐
畑树树树树树树树树树树树树树树树树水水水土土树树树树树树树树树树树树树树树树树树树树树树树树水水土土土李树树树树树树树树┣┗┛┌入┐┣
树树树树树树树树树树树树树树树树树水水水土土树树树树树树树树树树树树树树树树树树树树树树水水水水土土稂稂稂稂稂稂稂稂树树┗┻┻┛穴┣┣
树树树树树树树树树树树树树树树树水水水水土土树树树树树树树树树树树树树树树树树树树树树树水水水水土土稂稂树稂树稂稂稂树树穴穴穴穴穴┣┣
树树树树树树树树树树树树树树树土水水水树土土树树树树树树树树树树树树树树树树树树树树水水水水土土土草稂稂稂稂稂稂树树树树穴┏┲┳┳┳┳
树树树树树树土土土土土土土土土土橋橋道道土土树树树树树树树树树树树树树树树树树树树树水水水水土树草草稂树稂稂稂稂树畑畑畑畑┣┣穴穴┏┳
树树树树树树土土土土土土土土土土橋橋道道土土土土草树树树树树树树树树树树树树树树树树水水土土土草草草稂稂稂树稂稂树畑畑畑畑┣┣穴穴═穴
树树树树树树土土树树树草草土土水水水道道土土土土草草草草树树树树树树树树树树树树树树水水土土草草草草稂稂稂稂稂稂树畑畑畑畑┣┗║┐┣穴
树树树树树树土土树树树树草土土水水水道道土土土土土树草草草草树树树树树树树树树树树树水水土土稂稂稂稂稂稂稂稂树稂树畑畑畑畑┣穴穴┣┣穴
