無無無無無無無無無無無無無無無無無無無無無無無無無無無
無無無無無無無無無無無無無無無無無無無無無無無無無無無
無無無無無無無無無無無無無無無無無無無無無無無無無無無
無無無無無無無無無無無無無無無無無無無無無無無無無無無
無無無無無無無無無無無無無無無無無無無無無無無無無無無
無無無無無無無無無無無無無無無無無無無無無無無無無無無
無無無無無無無無無無無無無無無無無無無無無無無無無無無
無無無無無無無無無無無無無無無無無無無無無無無無無無無
無無無無無無無無無無無無無無無無無無無無無無無無無無無
無無無無無無無無無無無無無無無無無無無無無無無無無無無
無無無無無無無無無無無無無無無無無無無無無無無無無無無
無無無無無無無無無無無無無無無無無無無無無無無無無無無
無無無無無無無無無無無無無無無無無無無無無無無無無無無
無無無無無無無無無無無無無無無無無無無無無無無無無無無
無無無無無無無無無無無無無無無無無無無無無無無無無無無
無無無無無無無無無無無無無無無無無無無無無無無無無無無
無無無無無無無無無無無無無無無無無無無無無無無無無無無
無無無無無無無無無無花李土仏土土李無無無無無無無無無無
無無無無無無無無無無寺寺土土花寺寺無無無無無無無無無無
無無無無無無無無無無寺寺寺寺寺寺寺無無無無無無無無無無
無無無無無無無無無無寺寺寺寺寺寺寺無無無無無無無無無無
無無無無無無無無無無寺寺寺寺寺寺寺無無無無無無無無無無
無無無無無無無無無無寺寺寺寺寺寺寺無無無無無無無無無無
無無無無無無無無無無寺寺寺寺寺寺寺無無無無無無無無無無
無無無無無無無無無無寺寺寺寺寺寺寺無無無無無無無無無無
無無無無無無無無無無無無無门無無無無無無無無無無無無無
無無無無無無無無無無無無無無無無無無無無無無無無無無無