無無無┌┻┻┻┻┻┻┻┻┻┐無無無無無無無無無
無無無┫穴穴穴穴穴穴穴穴穴┣┏┳┳┳┓無無無無
無無無┳u┳┓穴┏┲┲┱┱┳┣穴穴穴┫無無無無
無無無無無無┫穴┣┣┗┛┫穴═穴穴穴┫無無無無
無無無無無┌┛穴══穴穴┫穴┗║┻║┛無無無無
無無無無無┫穴穴┣┣穴穴─穴穴穴┌║┻┐無無無
無無無無無┲┳┱┳┗║┻┛┌║┻┛穴穴┣無無無
無無無無無┣穴┫穴┌║┐穴─穴穴穴穴穴┣無無無
無無無無無┣穴─穴─穴┣穴┳┳┳┳┳┳┳┏┓無
無無無無無┗║┛穴┳┳┳穴穴穴穴穴穴穴穴┣┫無
無無無┌┻┻║┐穴穴穴穴穴┌┻┻┻┻┐穴┣┫無
無無無┫穴穴穴┗┻┻┻┻┻┛┌入┐穴═穴┣┫無
無無無┫穴穴穴穴穴┏┳┳┓穴─穴═穴┣穴┣┫無
無無無┫穴穴穴穴穴═穴穴─穴┳┳┳穴┣穴┗┛無
無無無┳u┳┓穴穴┗┐┌┛穴穴穴穴穴┗║┻┐無
無無無無無無┳┓穴穴┗┛穴穴穴穴穴穴穴穴穴┣無
無無無無無無無┳┳┳┳┳┳┳┳┳┳┳┳┳┳┳無