树树树石石石树树树树树树树树树树树土土草草土土草草稂稂草草树树树树树树树树树树水水树树树树树树土土土土土土树树树树树树树树道道道道飾飾飾飾石石石石石
树树树石石石石石石石树树树树树树树草草草草草草草草稂稂稂稂树树树树树树树树树树水水树树树树树树土土树树树树树树树树树树树树無道無無飾飾飾飾石石石石石
树树石石石石石石石石石石石石树树树草草草草草草草草稂稂稂稂树树树树树树树树树树水水树树树树树树土土树树树树树树树树树树树树道道道道無無無無石石石石石
石石石石石石石石石石石石石石石石石石石树树稂稂树树树树树树树树树树树树树树树树水水树树树树树树土土树树树树树树树树树树树树道道道道無门館無土土石石石
石石石石石石石石石石石石石石石石石石石树树稂稂树树树树树树树树树树树树树树树树水水树树树树树树土土树树树树树树树树树树树树道道道道道道道道道道道石石
石石石石石石石石石石石石石石石石石石石石石稂稂树树树树树树树树树树树树树树树树水水树树树树树树土土土土树树树树飾飾飾飾土土道道道道道道道道道道道石石
石石石石石石石石石石石石石石石石石石石石石稂稂石石石石石石石石石石石石石石石树水水树树树树树树土土土土树树树树飾飾飾飾土花道道道道土花土花土道道石石
水水水水水水石石石石石石石石石石石石石石石稂稂石石石石石石石石石石石石石石石树水水树树树树树树土土土土树树树树無门無無花土道道道道花土花土花道道石石
水水水水石石石石石石石石石石石石石石石石石稂稂石石石石石石石石石石石石石石石树水水树树树树树树土土土土树树树树道道道道道道道道道道土土土土土道道石石
水石岩石石石石石石石石石石石石石石石石石石稂稂飾飾飾飾石石石石石石石石石石石树水水树树树树树树石石土土树树树树道道道道道道道道道道土土土土土道道石石
水石石石石石石石石石石石石石石石石石石石石道道無门無無石石石石石石石石石石石树水水树树树树树树石石土土树树树树树树树树树树树树土土土土土土土道道道道
嶝嶝嶝石石石石石石石石石石石石石石石石石石道道道道道道道石石石石草草草草土土草橋橋草草草嶝嶝嶝石石土土土土土土土土土土土土土树土土土土土土土道道道道
石石嶝石岩入石石岩石石石石石石石石石石石石道道道道道道道石石石石草草草草土土草橋橋草草草嶝嶝嶝石石土土树树树树树土土飾飾飾飾树树树树树树树树树树树树
石石嶝石石嶝石石石石石石石石石石石石石石石道道石石石道道石石石石石石草草石石树水水稂稂稂稂嶝嶝石石土土树树树树树土土無门無無花土花土树树树树树树树树
石石嶝嶝嶝嶝石石石石石石石石石石石石石石石道道石石石道道石石石石石石草草石石树水水稂稂稂稂嶝嶝嶝嶝土土土土树树树土土土土土土土花土花树树树树树树树树
石石石石石石石石石石石石石石石石石石石石石嶝嶝石石石稂稂稂稂草草石石草草石石树水水石石石石嶝嶝嶝嶝土土土土树树树土土土土土土花土花土树树树石石石石石
石石岩石岩石石石石石石石石石石石石石石石石嶝嶝石石石稂稂稂稂草草石石草草石石树水水石石石石石石石石树树土土树树树树树土土树树树树树树树树树石石石石石
飾飾飾飾石石石石石石石石石石石石石入石石石嶝嶝石石石石石石石草草石石草草石石树水水飾飾飾飾石石石石石石土土树畑畑畑畑畑畑畑畑畑树树树树树树石石石石石
無门学無石石石石石石石石石石石石石嶝嶝石石嶝嶝石石石石石石石草草土花土花石石石水水無门無無石石石石石石土土树畑畑畑畑畑畑畑畑畑树树树树树树石石石石石
土土石石石石石石石石石石石石石石石嶝嶝石石嶝嶝嶝嶝嶝嶝石石石草草花土花土石石石水水道道道道石石石石石石土土树畑畑畑畑畑畑畑畑畑树树树树树树石石石石石
石石石石石石石石石石石石石石石石石嶝嶝石石嶝嶝嶝嶝嶝嶝石石石石石石石石石石石石水水道道道道石石石石石石土土树畑畑畑畑畑畑畑畑畑树树石石石石石石石石石
石石石石石石石石石石石石石石石石石嶝嶝石石石石石石嶝嶝石石石石石石石石石石石石水水石石土土土土土土土土土土树畑畑畑畑畑畑畑畑畑树树石石石石石石石石石
石石石石石石石石石石石石石石石石石嶝嶝石石石石石石嶝嶝石石石石石石石石石石石石水水石石土土土土土土土土土土树畑畑畑畑畑畑畑畑畑树树石入石石石石石石石
石石石石石石石石石石石石石石石石石嶝嶝嶝嶝飾飾飾飾嶝嶝石石石石石石石石石石石石水水石石嶝嶝石石石石草草草草树畑畑畑畑畑畑畑畑畑树树树土石石石石石石石
石石石石石石石石石石石石石石石石石嶝嶝嶝嶝無门無無嶝嶝石石石嶝嶝嶝嶝嶝嶝嶝嶝石水水石石嶝嶝石石石石草草草草树畑畑畑畑畑畑畑畑畑土土土土石石石石石石石
石石石石石石石石石石石石石石石石石石石嶝嶝道道道道嶝嶝石石石嶝石石石石石石嶝嶝滝滝嶝嶝嶝嶝石石石石草草草草树树树树树树树树树树树树树树石石石石石石石
树石石石石石石石石石石石石石石石石石石嶝嶝道道道道嶝嶝嶝嶝嶝嶝石石石石石石石石水水石石嶝嶝石石石石草草草草树树树树树树树树树树树树树树石石石石石石石
树石石石石石石石石石石入石石石石石石石石石石石石石石石石石石石石石石石石石石石水水石石嶝嶝石石石石土土草草树树树树树树树树树树树树石石石石石石石石石
树石石石石石石石石石石土土石石石石石石石石石石石石石石石石石石石石石石石石石石水水石石嶝嶝石石石石土土草草树树树树树树树树树树树树石石石石石石石石石
树树石石石石石石石石石土土石石石石石石石石石石石石石石石石石水水水水水水水石石水水树树土土草草草草草草树树树树树树树树树树树树树树石石石石石石石石石
树树石石石石石石石树树土土树树树树树树树树树树石石石石石石石水水水水水水水石石水水树树土土草草草草草草树树树树树树树树树树树树树树石石石石石石石石石
树树石石石石石石石树树土土树树树树树树树树树树石石石石石石石水水土土土水水石石水水树树草草土土草草树树树树树树树树树树树树树树石石石石石石石石石石石
树树树石石石石石石树树花李花花花花花李花花树树石石石石石石石水水土果土水水水水水水树树草草土土草草树树树树树树树树树树树树树树石石石石石石石石石石石
树树树石石石石石石树树花花李花李花花花花花树树石石石石石石树水水土土土水水水水水水土土土土道道树树石石石石树树树树树树树树树树树树石石石石石石石石石
水水水水水石石石石树树花花水水水水水水花李树树石石石石石石树水水水稂稂水水水水水水土土土土道道树树石石石石树土草土土土土草土土树树石入石石石石石石石
水水水水水石石石石树树李花水华水水华水花花树树石入石石石石树水水水稂稂稂稂草草草草土土土土道道石石石石石石树李水水水水水水水李树树树土石石石石石石石
树树树水水石石石石树树花花水水水水水水花花树树土土土石石石树树水水稂稂稂稂草草草草土土土土道道石石石石石石树土华土草土土李水土树树土土石石石石石石石
树树树水水石石石石树树花李花花李花花李花花土土土果土石石石树树水水水水草草草草石石石石石石道道嶝嶝嶝岩嶝石树土水花水水水土水土土土土树石石石石石石石
树树树水水石石石石树树花花花花花花花花花花土土土土土石石石树树水水水水草草草草石石石石石石道道嶝岩嶝嶝嶝石树草水土水仏水土水土树树树树石石石石石石石
树树树水水石石石石树树树树树树树树树树树树树树石石石石石石树树树树水水草草草草石石石石土土道道石石石石石石树土水土水华水土水土树树树树树树石石石石石
树树树水水石石石石树树树树树树树树树树树树树树石石石石石石树树树树水水草草草草石石石石土土道道石石石石石石树花水土土土李土水土树树树树树树石石石石石
树树树水水石石石石石石石石石石石石石石石石石石石石石石石石树树树树水水草草草草草草道道道道道道石石石石石石树土水水水水水华水草树树树树树树石石石石石
树树树水水石石石石石石石石石石石石石石石石石石石石石石石石树树树树水水草草草草草草道道道道道道石石石石石石树土草土土草土土土花树树树树树树石石石石石
树树树水水石石石石石石石石石石石石石石石石石石石石石石水水水水水水水水土土道道道道道道石石石石石石石石石石树树树树树树树树树树树树树树树树树树树树树
树树树水水石石石石石石石石石石石石石石石石石石石石石石水水水水水水水水土土道道道道道道石石石石石石石石石石树树树树树树树树树树树树树树树树树树树树树
树树树水水水水树树树树树树树树树树树树树树树树树树树树水水土土土土水水水水道道石石石石石石石石石石石石石石树树树树树树树树树树树树树树树树树树树树树
树树树水水水水树树树树树树树树树树树树树树树树树树树树水水土土土土水水水水道道石石石石石石石石石石石石石石树树树树树树树树树树树树树树树树树树树树树
树树树树树水水树树树树树树树树树树树水水水水水水水水水水水道道道道道道橋橋道道石石石石石石石石石石石石石石树树树树树树树树树树树树树树树树树树树树树
树树树树树水水树树树土花土花土花土花水水水水水水水水水水水道道道道道道橋橋道道石石石石石石石石石石石石石石树树树树树树树树树树树树树树树树树树树树树
树树树树树水水树树树花飾飾飾飾飾飾土水水飾飾飾飾树飾飾飾飾道道树树树树水水石石石石石石石石石石石石石石石石石石石石石石石石树树树树树树树树树树树树树
树树树树树水水水水水土飾飾飾飾飾飾花水水無门無無土飾飾飾飾道道树树树树水水石石石石石石石石石石石石石石石石石石石石石石石石树树树树树树树树树树树树树
树树树树树水水水水水花無無無無無無土水水道道道道道無無無無道道石石水水水水石石石石稂稂稂稂稂稂稂稂稂稂稂石石石石石石石树树树树树树树树树树树树树树树
石石树树树树树树水水土無無门学無無花水水道道道道道無门館無道道石石水水水水石石石石稂稂稂稂稂稂稂稂稂稂稂石石石石石石石树树树树树树树树树树树树树树树
草草草草草土土树水水花土花土花土花土水水飾飾飾飾道道道道道道道树树水水石石石石石石稂稂石石草草草稂稂垣垣垣垣垣垣垣垣垣垣垣垣垣树树树树树树树树树树树
草草草草草土土树水水水水水橋橋水水水水水飾飾飾飾道道道道道道道树树水水石入石石石石稂稂石石草草草稂稂垣畑畑畑畑畑畑畑畑畑畑畑垣树树石石树树树树树树树
树石石石石土土树水水水水水橋橋水水水水水無無無無土道道道道土土土土水水石土石石石石草草草草草草草稂稂垣土树土土树土土树土土树垣树树石石树树树树树树树
树石石石石土土树树土土道道道道道道道道道無门買無土道道道道土土土土水水土土稂稂稂稂草草草草草草草稂稂垣畑畑畑畑畑畑畑畑畑畑畑垣石石石石石石石树树树树
石石石石石土土土土土土道道道道道道道道道道道道道道道道道道土土土土水水水水水水稂稂石石草草飾飾飾飾飾飾土土树土土树土土树土土垣石石石石石石石树树树树
石树树树树土土土土土土道道道道道道道道道道道道道道道道道道树树树树飾水水水水水稂稂石石草草飾飾飾飾飾飾畑畑畑畑畑畑畑畑畑畑畑垣石石石石石石石石石树树
树树树树树稂稂树树树树道道飾飾飾飾飾飾土土道道土土飾飾飾飾树树树飾飾飾土土水水水水水草草草飾飾飾飾飾飾树土土树土土树土土树土垣石石石石石石石石石树树
树树树树树稂稂树树树树道道飾飾飾飾飾飾土土道道土土無门無無树树飾飾無飾飾土水水水水水草草草飾飾飾飾飾飾畑畑畑畑畑畑畑畑畑畑畑垣石石石石石石石石石树树
稂稂稂稂稂稂稂树树树树道道無無無無無無土土道道道道道道道道道道飾無無無飾仏土土土水水土土土無無無無無無土树土土树土土树土土树垣石石石石石石石石石树树
稂稂稂稂稂稂稂树树树树道道無無门競無無土土道道道道道道道道道道無無门無無土土土土水水土土土無门無無门無畑畑畑畑畑畑畑畑畑畑畑垣石石石石石石石石石树树
石石稂稂稂稂稂树树树树道道道道道道道道道道道道土花树树石石道道道道道道道道道道道橋橋道道道道道树树土土土土土土水水水水水水水水水水石石石石石石石树树
石石石石树树树树树树树道道道道道道道道道道道道李土树树石石道道道道道道道道道道道橋橋道道道道道树树土土土土土土水水水水水水水水水水石石石石石石石树树
石石石石石石树树树树树树树树树树树树树树树树树树树树树树树树树树树树树树树树土土水水水水水水水水水水水水土树土水水树树树石石石石石石石石石石石石石石
石石石石石石石石树树树树树树树树树树树树树树畑畑畑畑畑畑畑畑树树树树树树树树土土水水水水水水水水水水水水土土土水水树树树石石石石石石石石石石石石石石
石石石石石石石石石石树树树树树树树树树树树树畑畑畑畑畑畑畑畑树树树树树树树树土土水水树树树树树树树树水水水水水水水树树树石石石石石石石石石石石石石石
石石石石石石石石石树树树树树树树树树树树树树畑畑畑畑畑畑畑畑树树树树树树树树土土水水树树树树树树树树水水水水水水水树树树石石石石石石石石石石石石石石
石石石石石石石石石树树树树树树树树树树树树树畑畑畑畑畑畑畑畑树树树树树树树树土土水水树树树树树树树树树树树树树树树树树树石石石石入石石石石石石石石石
石石石石石石石石石石树树树树树树树树树树树树畑畑畑畑畑畑畑畑树树树树树树树树土土水水树树树树树树树树树树树树树树树树树树石石石石穴石石石石石石石石石
树树树石石石石石石石石树树树树树树树树树树树畑畑畑畑畑畑畑畑树树树树树树水水橋橋水水树树树树树树树树树树树树树树树树树树石石石石穴穴穴石石石石石石石
树树树树树树石石石石石石树树树树树树树树树树畑畑畑畑畑畑畑畑树树树树树树水水橋橋水水树树树树树树树树树树树树树树树树树树石石石石石石穴穴石石石石石石
树树树树树水水石石石石石石树树树树树树树树树土土飾飾飾飾树树树树树树树树水水土土树树树树草草草草草草草草树树树树树树树树石石石石石穴穴穴石石石石石石
树树树树树水水水石石石石石石树树树树树树树树土土無门無無树树树树树树树树水水土土树树树树草草草草草草草草树树树树树树树树石石穴穴石石穴穴穴穴石石石石
树树树树树水水水石石石石石石石树树树树树树树土土土土土土土土土土土土土土橋橋土土土土土土草草土土土土土土树树树树树树树树石穴岩穴穴穴石穴穴穴石石石石
树树树树树水水岩石石石石石石石树树树树树树树土土土土土土土土土土土土土土橋橋土土土土土土草草土土土土土土树树树树树树树树石穴穴穴岩穴石穴穴穴石石石石
树树树树水水水石石石石石石石石石石石石石石树土土树树树树树树树树树树树树水水畑畑畑畑土土土土土土畑畑土土草草草草草草树树石穴岩穴穴穴穴穴岩穴石石石石
水水水水水岩水石石石石石石石石石石石石树石石土土树树树树树树树树树树树树水水畑畑畑畑土土土土土土畑畑土土草草草草草草树树石穴穴石穴岩穴穴穴穴石石石石
水水水水水水水石石石石石石石石石树穴穴穴穴石土土树树树树树树树树树树树树水水畑畑畑畑畑畑畑畑畑畑畑畑土土草草草草草草草草穴穴穴石穴穴穴岩穴穴石石石石
岩穴穴穴穴石石石石石石石石石石石石石穴石穴石穴穴树树树树树树树树树树树树水水畑畑畑畑畑畑畑畑畑畑畑畑土土草草草草草草草草穴穴穴石穴穴石穴穴石石石石石
穴穴穴石石石石石石石石石石石石石入石穴石穴石穴穴树树树树树树树树树树树树水水畑畑畑畑畑畑畑畑畑畑畑畑土土草草树树树树树树石穴石穴穴石石石石石石石石石
穴穴石石石石石石石石石石石石石穴穴穴穴石穴石穴穴树树树树树树树树树树树树水水畑畑畑畑畑畑畑畑畑畑畑畑土土草草树树树树树树石石石石石石石石石石石石石石
穴石石石石石石石石石石石石石石石石石石石穴石穴穴树树树树树树树树树树树树水水畑畑畑畑土土土土土土畑畑土土树树树树树树树石石石石石石石石石石石石石石石
穴石石石石石石石石石石石石石石石石穴穴穴穴石穴石树树树树树树树树树树树树水水飾飾飾飾土土土土土土畑畑土土树树树树树树树石石石石石石石石石石石石石石石
石石入石石石石石石石石石石石石石石穴石石石石穴石树树树树树树树树树树树树水水無门無無土土树树土土土土土土树树树树树树石石石石石石石石石石石石石石石石