树树树石石石树树树树树树树树树树树土土草草土土草草稂稂草草树树树树树树树树树树水水树树树树树树土土土土土土树树树树树树树树道道道道飾飾飾飾树树树树
树树树石石石石石石石树树树树树树树草草草草草草草草稂稂稂稂树树树树树树树树树树水水树树树树树树土土树树树树树树树树树树树树無道無無飾飾飾飾树树树树
树树石石石石石石石石石石石石树树树草草草草草草草草稂稂稂稂树树树树树树树树树树水水树树树树树树土土树树树树树树树树树树树树道道道道無無無無树树树树
树树石石石石石石石石石石石石石石石石石树树稂稂树树树树树树树树树树树树树树树树水水树树树树树树土土树树树树树树树树树树树树道道道道無门無無土土树树
树树石石石石石石石石石石石石石石石石石树树稂稂树树树树树树树树树树树树树树树树水水树树树树树树土土树树树树树树树树树树树树道道道道道道道道道道道树
树树石石石石石石石石石石石石石石石石石石石稂稂树树树树树树树树树树树树树树树树水水树树树树树树土土土土树树树树飾飾飾飾土土道道道道道道道道道道道树
树石石石石石石石石石石石石石石石石石石石石稂稂石石石石石石石石石石石石石石石树水水树树树树树树土土土土树树树树飾飾飾飾土花道道道道土花土花土道道树
树石石石石石石石石石石石石石石石石石石石石稂稂石石石石石石石石石石石石石石石树水水树树树树树树土土土土树树树树無门無無花土道道道道花土花土花道道树
树石石石石石石石石石石石石石石石石石石石石稂稂石石石石石石石石石石石石石石石树水水树树树树树树土土土土树树树树道道道道道道道道道道土土土土標道道树
树石石石石石石石石石石石石石石石石石石石石稂稂飾飾飾飾石石石石石石石石石石石树水水树树树树树树石石土土树树树树道道道道道道道道道道土土土土土道道树
石石石石石石石石石石石石石石石石石石石石石道道無门無無石石石石石石石石石石石树水水树树树树树树石石土土树树树树树树树树树树树树土土土土土土土道道道
石石石石石石石石石石石石石石石石石石石石石道道道道道道道石石石石草草草草土土草道道草草草嶝嶝嶝石石土土树树树树树树树树树树树树土土土土土土土道道道
石石石石石石石石石石石石石石石石石石石石石道道道道道道道石石石石草草草草土土草道道草草草嶝嶝嶝石石土土树树树树树树树飾飾飾飾树树树树树树树树树树树
石石石石石石石石石石石石石石石石石石石石石道道石石石道道石石石石石石草草石石树水水稂稂稂稂嶝嶝石石土土土土树树树树树無门無無树树树树树树树树树树树
石石石石石石石石石石石石石石石石石石石石石道道石石石道道石石石石石石草草石石树水水稂稂稂稂嶝嶝嶝嶝土土土土树树树树树土土土土树树树树树树树树树树树
石石石石石石石石石石石石石石石石石石石石石嶝嶝石石石稂稂稂稂草草石石草草石石树水水石石石石嶝嶝嶝嶝土土土土树树树树树土土土土土树树树树树树树树树树
石石石石石石石石石石石石石石石石石石石石石嶝嶝石石石稂稂稂稂草草石石草草石石树水水石石石石石石石石树树土土树树树树树树树土树树树树树树树树石石石石
石石石石石石石石石石石石石石石石石入石石石嶝嶝石石石石石石石草草石石草草石石树水水飾飾飾飾石石石石石石土土树树树树树树树土树树树树树树树树石石石石
石石石石石石石石石石石石石石石石石嶝嶝石石嶝嶝石石石石石石石草草土花土花石石石水水無门無無石石石石石石土土树树树土土土土土树树树树树树树树石石石石
石石石石石石石石石石石石石石石石石嶝嶝石石嶝嶝嶝嶝嶝嶝石石石草草花土花土石石石水水道道道道石石石石石石土土土土土土树树树树树树树树树树树石石石石石
石石石石石石石石石石石石石石石石石嶝嶝石石嶝嶝嶝嶝嶝嶝石石石石石石石石石石石石水水道道道道石石石石石石土土树树树树树树树树树树树树树树树石石石石石
石石石石石石石石石石石石石石石石石嶝嶝石石石石石石嶝嶝石石石石石石石石石石石石水水石石嶝嶝嶝嶝土土土無土土树树树树树树树树树树树树树树石石石石石石
石石石石石石石石石石石石石石石石石嶝嶝石石石石石石嶝嶝石石石石石石石石石石石石水水石石嶝嶝嶝嶝土土土無土土树树树树树树树树树树树树树树石石石石石石
石石石石石石石石石石石石石石石石石嶝嶝嶝嶝飾飾飾飾嶝嶝石石嶝嶝嶝嶝嶝嶝嶝嶝嶝嶝水水石石嶝嶝石石石石土無草草树树树树树树树树树树树树树树石石石石石石
石石石石石石石石石石石石石石石石石嶝嶝嶝嶝無门無無嶝嶝石石嶝嶝嶝嶝嶝嶝嶝嶝嶝嶝水水石石嶝嶝石石石石無無草草树树树树树树树树树树树树树石石石石石石石
石石石石石石石石石石石石石石石石石石石嶝嶝道道道道嶝嶝嶝嶝嶝嶝石石石石石石嶝嶝道道嶝嶝嶝嶝石石石石草草草草树树树树树树树树树树树树树石石石石石石石
树石石石石石石石石石石石石石石石石石石嶝嶝道道道道嶝嶝嶝嶝嶝嶝石石石石石石嶝嶝道道嶝嶝嶝嶝石石石石草草草草树树树树树树树树树树树树石石石石石石石石
树石石石石石石石石石石入石石石石石石石石石石石石石石石石石石石石石石石石石石石水水石石嶝嶝石石石石土土草草树树树树树树树树树树树树石石石石石石石石
树石石石石石石石石石石土土石石石石石石石石石石石石石石石石石石石石石石石石石石水水石石嶝嶝石石石石土土草草树树树树树树树树树树树树石石石石石石石石
树树石石石石石石石石石土土石石石石石石石石石石石石石石石石石水水水水水水水石石水水树树土土草草草草草草树树树树树树树树树树树树树石石石石石石石石石
树树石石石石石石石树树土土树树树树树树树树树树石石石石石石石水水水水水水水石石水水树树土土草草草草草草树树树树树树树树树树树树树石石石石石石石石石
树树石石石石石石石树树土土树树树树树树树树树树石石石石石石石水水土土土水水石石水水树树草草土土草草树树树树树树树树树树树树树树石石石石石石石石石石
树树树石石石石石石树树花李花花花花花李花花树树石石石石石石石水水土果土水水水水水水树树草草土土草草树树树树树树树树树树树树树树石石石石石石石石石石
树树树石石石石石石树树花花李花李花花花花花树树石石石石石石树水水土土土水水水水水水土土土土道道树树石石石石树树树树树树树树树树树石石石石石石石石石
水水水水水石石石石树树花花水水水水水水花李树树石石石石石石树水水水稂稂水水水水水水土土土土道道树树石石石石树树树树树树树树树树树石石石石石石石石石
水水水水水石石石石树树李花水华水水华水花花树树石入石石石石树水水水稂稂稂稂草草草草土土土土道道石石石石石石树树树树树树树树树树树树石石石石石石石石
树树树水水石石石石树树花花水水水水水水花花树树土土土石石石树树水水稂稂稂稂草草草草土土土土道道石石石石石石树树树树树树树树树树树树树石石石石石石石
树树树水水石石石石树树花李花花李花花李花花土土土果土石石石树树水水水水草草草草石石石石石石道道石石石石石石树树树树树树树树树树树树树石石石石石石石
树树树水水石石石石树树花花花花花花花花花花土土土土土石石石树树水水水水草草草草石石石石石石道道石石石石石石树树树树树树树树树树树树树树石石石石石石
树树树水水石石石石树树树树树树树树树树树树树树石石石石石石树树树树水水草草草草石石石石土土道道石石石石石石树树树树树树树树树树树树树树石石石石石石
树树树水水石石石石树树树树树树树树树树树树树树石石石石石石树树树树水水草草草草石石石石土土道道石石石石石石树树树树树树树树树树树树树树树石石石石石
树树树水水石石石石石石石石石石石石石石石石石石石石石石石石树树树树水水草草草草草草道道道道道道石石石石石石树树树树树树树树树树树树树树树树石石石石
树树树水水石石石石石石石石石石石石石石石石石石石石石石石石树树树树水水草草草草草草道道道道道道石石石石石石树树树树树树树树树树树树树树树树石石石石
树树树水水石石石石石石石石石石石石石石石石石石石石石石水水水水水水水水土土道道道道道道石石石石石石石石石石树树树树树树树树树树树树树树树树树石石石
树树树水水石石石石石石石石石石石石石石石石石石石石石石水水水水水水水水土土道道道道道道石石石石石石石石石石树树树树树树树树树树树树树树树树石石石石
树树树水水水水树树树树树树树树树树树树树树树树树树树树水水土土土土水水水水道道石石石石石石石石石石石石石石树树树树树树树树树树树树树树树树石石石石
树树树水水水水树树树树树树树树树树树树树树树树树树树树水水土土標土水水水水道道石石石石石石石石石石石石石石树树树树树树树树树树树树树树树石石石石石
树树树树树水水树树树树树树树树树树树水水水水水水水水水水水道道道道道道道道道道石石石石石石石石石石石石石石树树树树树树树树树树树树树树树石石石石石
树树树树树水水树树树树土土土土树树树水水水水水水水水水水水道道道道道道道道道道石石石石石石石石石石石石石石树树树树树树树树树树树树树树石石石石石石
树树树树树水水树树树树土土土土树石石水水飾飾飾飾树飾飾飾飾道道树树树树水水石石石石石石石石石石石石石石石石石石石石石石石石树树树树树树石石石石石石
树树树树树水水水水水水土土土土树石石水水無门無無土飾飾飾飾道道树树树树水水石石石石石石石石石石石石石石石石石石石石石石石石石树树树树石石石石石石树
树树树树树水水水水水水土土飾飾飾飾水水水水道道道道無無無無道道石石树树水水水水水水树树树树树树树树树树石石石石石石石石石石石石树树树石石石石石石树
石石树树树树石石石水水土土無门無無水水水水道道道道無门無無道道石石土土水水水水水水树树树树树树树树树树石石石石石石石石石石石石石树石石石石石石石树
草草草草草土土石石水水土土道道土土水水飾飾飾飾道道道道道道道道树树土土石石石土水水树树石石树树树树树树石石石石石石石石石石石石石石石石石石石石石树
草草草草草土土石石水水土土道道土土水水飾飾飾飾道道道道道道道道树树土土石入石土水水树树石石树树树树树树石石石石石石石石石石石石石石石石石石石石石树
树石石石石土土石石水水水水道道水水水水無無無無土土道道道道土土土土土土石土石土水水树树树树树树树树树树石石石石石石石石石石石石石石石石石石石石石树
树石石石石土土標石水水水水道道水水水水無门無無土標道道道道土土土土土土土土土土水水树树树树树树树树树树石石石入石石石石石石石石石石石石石石石石石树
石石石石石土土土土土土道道道道道道道道道道道道道道道道道道土土土土土土土土土土水水石石树树树树树树土土無土土土土土石石石石石石石石石石石石石石石树
石树树树树土土土土土土道道道道道道道道道道道道道道道道道道树树树树無無無土無無水水石石树树树树土土土土無土土土土土石石石石石石石石石石石石石石石树
树树树树树稂稂树树树树道道飾飾飾飾飾飾土土道道土土飾飾飾飾树树树树土土土土土土水水水树树树石石土土土土無土土土土土石石石石石石石石石石石石石石石树
树树树树树稂稂树树树树道道飾飾飾飾飾飾土土道道土土無门無無树树树树土土土土土土土水水土树树石石土土土土無無無無無道石石石石石石石石石石石石石石石树
稂稂稂稂稂稂稂树树树树道道無無無無無無土土道道道道道道道道石石飾飾飾飾道道道道道道道道道道道道道道道道道道土土土土土土石石石石石石石石石石石石石树
稂稂稂稂稂稂稂树树树树道道無無门無無無土土道道道道道道道道石石無门無無道道道道道道道道道道道道道道道道道道土土土土土土石石石石石石石石石石石石石石
石石稂稂稂稂稂树树树树道道道道道道道道道道道道土土树树石石道道道道道道道道树土土水水树树树树树树树草草草草草草土土土土石石石石石石石石石石石石石石
石石石石树树树树树树树道道道道道道道道道道道道土土树树石石道道道道道道道道树土土水水树树树树树树树草草草草草草土土土土石石石石石石石石石石石石石石
石石石石石石树树树树树树树树树树树树树树树树树树树树树树树树树树树树树树树树土土水水树树树树树树树树树树树树树树树树树树石石石石石石石石石石石石石
石石石石石石石石树树树树树树树树树树树树树树树树树树树树树树树树树树树树树树土土水水树树树树树树树树树树树树树树树树树树石石石石石石石石石石石石石
石石石石石石石石石石树树树树树树树树树树树树树树树树树树树树树树树树树树树树土土水水树树树树树树树树树树树树树树树树树树石石石石石石石石石石石石石
石石石石石石石石石树树树树树树树树树树树树树树树树树树树树树树树树树树树树树土土水水树树树树树树树树树树树树树树树树树树石石石石石石石石石石石石石
石石石石石石石石石树树树树树树树树树树树树树树树树树树树树树树树树树树树树树土土水水树树树树树树树树树树树树树树树树树树石石石石石石石石石石石石石
石石石石石石石石石石树树树树树树树树树树树树树树树树树树树树树树树树树树树树土土水水树树树树树树树树树树树树树树树树树树石石石石石石石石石石石石石
树树树石石石石石石石石树树树树树树树树树树树树树树树树树树树树树树树树树水水道道水水树树树树树树树树树树树树树树树树树树石石石石石石石石石石石石石
树树树树树树石石石石石石树树树树树树树树树树树树树树树树树树树树树树树树水水道道水水树树树树树树树树树树树树树树树树树树石石石石石石石石石石石石石
树树树树树水水石石石石石石树树树树树树树树树树树树树树树树树树树树树树树水水土土树树树树树树树树树树树树树树树树树树树树石石石石石石石石石石石石石
树树树树树水水水石石石石石石树树树树树树树树树树树树树树树树树树树树树树水水土土树树树树树树树树树树树树树树树树树树树树石石石石石石石石石石石石石
树树树树树水水树石石石石石石石树树树树树树树土土土土土土土土土土土土土土道道土土树树树树树树树树树树树树树树树树树树树树石石石石石石石石石石石石石
树树树树树水水石石石石石石石石树树树树树树树土土土土土土土土土土土土土土道道土土树树树树树树树树树树树树树树树树树树树树石石石石石石石石石石石石石
树树树树树水水石石石石石石石石石石石石石石树土土树树树树树树树树树树树树水水土土树树树树树树树树树树树树树树树树树树树树石石石石石石石石石石石石石
水水水水水水水石石石石石石石石石石石石树石石土土树树树树树树树树树树树树水水土土树树树树树树树树树树树树树树树树树树树树石石石石石石石石石石石石石
水水水水水水水石石石石石石石石石树穴穴穴穴石土土树树树树树树树树树树树树水水土土树树树树树树树树树树树树树树树树树树树树石石石石石石石石石石石石石
树树树树树树树石石石石石石石石石石石穴石穴石穴穴树树树树树树树树树树树树水水土土树树树树树树树树树树树树树树树树树树树树石石石石石石石石石石石石石
树树树树石石石石石石石石石石石石入石穴石穴石穴穴树树树树树树树树树树树树水水土土树树树树树树树树树树树树树树树树树树树树石石石石石石石石石石石石石
树树石石石石石石石石石石石石石穴穴穴穴石穴石穴穴树树树树树树树树树树树树水水土土树树树树树树树树树树树树树树树树树树树树石石石石石石石石石石石石石
树石石石石石石石石石石石石石石石石石石石穴石穴穴树树树树树树树树树树树树水水土土树树树树树树树树树树树树树树树树树树树石石石石石石石石石石石石石石
树石石石石石石石石石石石石石石石石穴穴穴穴石穴石树树树树树树树树树树树树水水土土树树树树树树树树树树树树树树树树树树树石石石石石石石石石石石石石石
石石入石石石石石石石石石石石石石石穴石石石石穴石树树树树树树树树树树树树水水土土树树树树树树树树树树树树树树树树树树石石石石石石石石石石石石石石石