無無無無無無無無無無無無無無無無無無無無無無無無無無無
無無無無無無無無無無無無無無無無無無無無無無無無無無無
無無無無無無無無無無無無無無無無無無無無無無無無無無無
無無無無無無無無無無無無無無無無無無無無無無無無無無無
無無無無無無無無無無無無無無無無無無無無無無無無無無無
無無無無無無無無無無無無無無無無無無無無無無無無無無無
無無無無無無無土土土土土土土土土土土無無無無無無無無無
無無無無無無無土花土土土花土土土花土無無無無無無無無無
無無無無無無無土土花土花土花土花土土無無無無無無無無無
無無無無無無無土土花土花土花土花土土無無無無無無無無無
無無無無無無無土花土土土花土土土花土無無無無無無無無無
無無無無無無無土土土土土土土土土土土無無無無無無無無無
無無無無無無無無無無無無土無無無無無無無無無無無無無無
無無無無無無無土土土土土土無無無土土土土土土無無無無無
無無無無無無無土花土土土土無無無土花土土土土無無無無無
無無無無無無無土土土土土土無無無土土土土土土無無無無無
無無無無無無無無無無無無土無無無無無無無無土無無無無無
無無無無無無無無無無無無土土土土土土土土土花無無無無無
無無無無無無無無無無無無土土花土土土土土土土無無無無無
無無無無無無無無無無無無土無無無無無土無無無無無無無無
無無無無無無無無無無無無花土土花土土土無無無無無無無無
無無無無無無無無無無無無土無無土無無土無無無無無無無無
無無無無無無無無無無無無土無無土無無土無無無無無無無無
無無無無無無無無無無無無土無無土無無土無無無無無無無無
無無無無無無無無無無無無土土土土土土土無無無無無無無無
無無無無無無無無無無無無门無無無無無無無無無無無無無無
無無無無無無無無無無無無無無無無無無無無無無無無無無無