無無無無無無無無無無無無無無無無無無無無無無無無無無無
無無無上無無無無無無無無無無道道道道道道道道道道無無無
無無無道無無無無無無無無無無道無無無树树树树树道無道無
無無道道道無無無無無無無無無道無無無树土土土树道無道無
無無道道道無無無無無無無無無道無道道土土土土树道無道無
無無道道道無無無無無無無無無道無道無树土李土土道無道無
無無無道無無無無無無無無無無道無道無土土土花树無無道無
道道道道道道道無無無無無無無道無道無土树树树树道道道無
無無無道無無無無無無無無無無道無道無道道道道道道無無無
無無無道無無無無無無無無無無道無道無無無無無無無無上無
無無無下無無無無無無無無無無下無道道道道道道道道道道無
無無無無無無無無無無無無無無無無無無無無無無無無無無無
無無無無無無無無無無無無無無無無無無無無無無無無無無無
無無無無無無無無無無無無無無無無無無無無無無無無無無無
無無無無無無無無無無無無無無無無無無無無無無無無無無無
無無無無無無無無無無無無無無無無無無無無無無無無無無無
無無無無無無無無無無無無無無無無無無無無無無無無無無無
無無無無無無無無無無無無無上無無無無無無無無無無無無無
無無無無無無無無無無無無道道道無無無無無無無無無無無無
無無無無無無無無無無無無道道道無無無無無無無無無無無無
無無無無無無無無無無無無道道道無無無無無無無無無無無無
無無無無無無無無無無無無無道無無無無無無無無無無無無無
無無無無無無無無無無道無道道道無道無無無無無無無無無無
無道道道道道道道道道道道道道道道道道道道道道道道道道無
無無無無無無無無無無道無道道道無道無無無無無無無無無無
無無無無無無無無無無無無無门無無無無無無無無無無無無無
無無無無無無無無無無無無無無無無無無無無無無無無無無無