树树树树树树树树树树树树树树树树树树树树树道垣道道道道垣垣垣垣垣垣垣道树树草草树树树树树树树树树树树树树树树树树树树树树树树树树树树树树树树树树
树树树树树树树树树树树树树树树树树树树树树道垣道道道道道道道道道道垣道树树草草树树树树树树树树树树树树树树树树树树树树树树树树树树树树树树树树树
树树树树树树树树树树树树树树树树树树树树树道垣道道道道道道道道道道垣道树树草草树树树树树树树树树树树树树树树树树树树树树树树树树树树树树树树树树
树树树树树树树树树树树树树树树树树树树树树道垣道道道道道道道道道道垣道树树草草树树树树树树树树树树树树树树树树树树树树树树树树树树树树树树树树树
树树树树树树树树树树树树树树树树树树树树树道垣道道道道道道道道道道垣道树树草草树树树树树树树树树树树树树树树树树树树树树树树树树树树树树树树树树
树树树树树树树树树树树树树树树树树树树树树道垣垣垣垣垣垣垣道道道道垣道树树草草树树树树树树树树树树树树树树树树树树树树树树树树树树树树树树树树树
道道树树树树树树树树树树树树树树树树树树树土土土土水水水水道道道道垣道树树草草树树树树树树树树树树树树树树树树树树树树树树树树树树树树树树树树树
道道道道树树树树树树树树树树树树树树树树树土土土土水水水水道道道道垣道土土土土树树树树树树树树树树树树树树树树树树树树树树树树树树树树树树树树树
道道道道道道树树树树树树树树树树树树树树树土土土土水水水水道道道道垣道土土土土树树树树树树树道道道道道道道道垣树树树树树树树树树树树树树树树树树
道道道道道道道道树树树树树树树树树树树树树土土土土水水水水道道道道垣道土土树树树树树树树树树道道道道道道道道垣树树树树树树树树树树树树树树树树树
树树道道道道道道道水水水水水水水水水水水水水水水水水水水水道道道道垣道土土树树树树树树树树树道道道道道道道道垣树树树树树树树树树树树树树树树树树
树树树树道道道道道水水水水水水水水水水水水水水水水水水水水道道道道垣垣垣垣垣垣垣垣垣垣垣垣垣垣垣道道道道道道垣树树树树树树树树树树树树树树树树树
树树树树树道道道道水水水水水水水水水水水水水水水水水水水水道道道道垣道道道飾飾飾飾道道道道道道垣道道道道道道垣树树树树树树树树树树树树树树树树树
树树树树树道道土土水水水水水水水水水水水水水水水水水水水水道道道飾垣飾飾飾無無無無道道道道道道垣道道道道道道垣树树树树树树树树树树树树树標树树树
树树树树树道道土土水水水水垣垣垣垣飾飾飾飾垣垣垣垣飾飾飾垣道道道道垣無無無道道道道道飾飾飾飾飾垣道道道道道道垣树树树树树树树树道道道道道道道道道
树树树树树道道土土水水水水垣飾飾飾無無無無飾飾飾道無無無垣垣道道垣垣飾飾飾飾道道道道無無無無無垣道道道道道道垣树树草草草草树树道道道道道道道道道
树树树树树道道土土水水水水垣無無無飾飾飾飾無無無飾飾飾飾垣路路路路垣無無無無道道道道道道道道道垣垣垣垣垣垣垣垣树树草草草草树树道道树树树树树道道
树树树树树道道土土水水水水垣道道道無無無無道道道無無無無垣路路路路道道道道道道道道道道道道道道道道道道道道道道無道道道道道道道道道树树树树树道道
树树树树树道道土土水水水水垣道道道道道道道道道道道道飾飾垣路路路路道道道道道道道道道道道道道道道道道道道道道道無道道道道道道道道道树树树树树標道
树树树树树道道土土水水水水垣道無無無無道道飾飾飾飾道無無垣路路路路垣道道道道道飾飾飾飾飾飾道道垣垣垣垣垣垣垣垣树树树树树树树树树树树树树树树道道
树树树树树道道土土水水水水垣道無無無無道道無無無無道道道垣路路路路飾飾垣垣道道無無無無無無道道垣道道道道道道垣树树树树树树树树树树树树树树树道道
树树树树树道道道道水水水水垣道無無無無飾飾道道飾飾飾飾道垣路路路路無無道道道道土土土土土土飾飾飾飾道道道道道垣树树树树树树树树树树树树树树树道道
树树树树树道道道道水水水水垣道無無無無無無道道無無無無道垣路路路路垣道道道道道土土土土土土無無無無道道道道道垣树树树树树树树树树树树树树树树草草
树树树树树道道土土水水水水垣道無無無無飾飾飾飾飾飾飾飾飾飾路路路路飾飾飾飾飾飾土土土土飾飾飾飾道道道道道道道垣树树树树树树树树树树树树树树树草草
树树树树树道道土土水水水水垣道無無無無無無门無無無飾飾飾飾路路路路飾飾飾飾飾飾土土土土無门無無道道道道道道道垣树树树树树树树树树树树树树树树树树
树树树树树道道土土水水水水垣道無無無無道飾道道道道無無無無路路路路無無無無無無垣垣垣垣道道垣垣道道道道道道道垣树树树树树树树树树树树树树树树树树
树树树树树道道土土水水水水垣道無無無無道道道道飾道無门無無路路路路無無门競無無道道道道道道道垣道道道道道道道垣树树树树树树树树树树树树树树树树树
树树树树树道道土土水水水水垣道無無無無路路路路路路路路路路路路路路路路路路路路道道飾飾飾飾飾飾道道道道道道道垣树树树树树树树树树树树树树树树树树
树树树树树道道土土水水水水垣道無無無無路路路路路路路路路路路路路路路路路路路路道道無無無门無無道道道道道道道垣树树树树树树树树树树树树树树树树树
树树树树树道道土土水水水水垣道無無無無飾飾飾飾飾飾道道道道路路路路道道道道道道道道道道道道道垣道道道道道道道垣树树树树树树树树树树树树树树树树树
树树树树树道道土土水水水水垣道無無無無飾飾飾飾飾飾垣垣垣垣路路路路垣垣垣垣垣垣垣垣垣垣垣垣垣垣垣垣垣垣垣垣垣垣树树树树树树树树树树树树树树树树树
树树树树树道道土土水水水水垣道無無無無無無無無無無道道道道道道道道道道飾飾飾飾道道道道道道道道道道道道道道道道树树树树树树树树树树树树树树树树树
树树树树树道道土土水水水水垣道無無無無無门無無無無道道道道道道道道道道飾飾飾飾道道道道道道道道道道道道道道道道树树树树树树树树树树树树树树树树树
树树树树树道道土土水水水水垣道無無無無道道飾道垣垣垣垣垣垣路路路路垣垣無無無無飾飾飾飾垣垣飾飾飾飾垣垣垣垣垣垣树树树树树树树树树树树树树树树树树
树树树树树道道土土水水水水垣道無门無無道道道道道道道道道道路路路路道道無無無無無無無無道道飾飾飾飾树树树树树树树树树树树树树树树树树树树树树树树
树树树树树道道道道道道道道路路路路路路路路路路路路路路路路路路路路路路路路路路路路路路路路無無無無树树树树树树树树树树树树树树树树树树树树树树树
树树树树树道道道道道道道道路路飾路路路路路路路路路路路路路路路路路路路路路路路路路路路路路無無無無树树树树树树树树树树树树树树树树树树树树树树树
树树树树树土土土土水水水水垣道道道道道道道道道飾飾飾飾飾飾路路路路飾道飾飾飾飾道道道道飾飾飾飾道道树树树树树树树树树树树树树树树树树树树树树树树
树树树树树土土土土水水水水垣垣垣垣道道道道道道飾飾飾飾飾飾路路路路道道無無無無道道道道無無無無道道树树树树树树树树树树树树树树树树树树树树树树树
树树树树树树树树树水水水水水水水水飾飾飾飾飾飾無無無無無無路路路路飾飾飾飾飾飾道道飾飾飾飾道道飾飾树树树树树树树树树树树树树树树树树树树树树树树
树树树树树树树树树水水水水水水水水無無無無無無無無门学無無路路路路飾飾飾飾飾飾道道無门無無道道無無树树树树树树树树树树树树树树树树树树树树树树树
树树树树树树树树树水水水水水水水水飾飾道道道道道道道道道道路路路路無無無無無無道道道道道道飾飾飾飾树树树树树树树树树树树树树树树树树树树树树树树
树树树树树树树树树水水水水水水水水無無道道道道道道道道道道路路路路無無無無無無道道道道道道無無無無树树树树树树树树水水水水水水水水水水水水水水水
树树树树树树树树树水水水水垣垣飾飾飾飾道道飾飾飾飾飾飾飾飾路路路路無無無無無無飾飾飾飾道道道飾飾飾树树树树树树树树水水水水水水水水水水水水水水水
树树树树树树树树树水水水水垣道無门無無道道無無無無飾飾飾飾路路路路無無無無無無無無無無道道道無無無树树树树树树树树水水水水水水水水水水水水水水水
树树树树树树树树树水水水水垣道道道道道道道道道道道無無無無路路路路無無無無無無飾飾飾飾道道飾飾道道树树树树树树树树水水水树树树树树树树树树树树树
树树树树树树树树树水水水水垣道道道道道道道道道道道無门無無路路路路無無门無無無飾飾飾飾道道無無道道树树树树树树树树水水水树树树树树树树树树树树树
树树树树树树树树树水水水水飾飾飾飾飾飾道道飾飾飾飾路路路路路路路路路路路路路路無無無無道道道飾飾飾树树树树树树树树水水水树树树树树树树树树树树树
树树树树树树树树树水水水水無無無無無無道道無门無無路路路路路路路路路路路路路路無门無無道道道無無無水水水水水水水水水水水树树树树树树树树树树树树
树树树树树树树树树水水水水水水飾飾道道道道道道道道飾飾飾飾路路路路道道道道飾飾飾道道道道飾飾飾飾飾水水水水水水水水水水水树树树树树树树树树树树树
树树树树树树树树树水水水水水水無無道道道道道道道道無無無無路路路路道道道道無無無道道道道無無無無無水水水水水水水水水水水树树树树树树树树树树树树
树树树树树树树树树树树水水水水道道飾飾飾飾飾飾飾飾道道飾飾路路路路飾飾飾飾道飾飾飾飾飾道飾飾飾道道水水水树树树树树树树树树树树树树树树树树树树树
树树树树树树树树树树树水水水水道道無無無無無無無無道道無無路路路路無無無無道無無無無無道無無無道道水水水树树树树树树树树树树树树树树树树树树树树
树树树树树树树树树树树水水水水飾飾道道道飾飾飾垣垣垣垣垣垣路路路路道道道道飾飾飾飾飾飾道道飾飾飾飾水水水树草土草土草土草树树树树树树树树树树树树
树树树树树树树树树树树水水水水無無道道道無無無道道道道道垣路路路路飾飾飾道飾飾飾飾無無道道無门無無水水水树土树土树土树土树树树树树树树树树树树树
树树树树树树树树树树树水水水水树树树树树道道道道道道道道垣垣道道垣無無無道無無無無道道道道道道道道水水水草土草土草土草土草树树树树树树树树树树树
树树树树树树树树树树树水水水水树树树树树道道道道道道道道垣垣道道垣垣飾飾道無门無無飾飾飾飾道道道道水水水土树土树土树土树土树树树树树树树树树树树
树树树树树树树树树树树水水水水树树树树树道道道道道道道道垣土土土土垣無無道道道道道無门無無道道道道橋橋橋土土土草土草土草土草树树树树树树树树树树
树树树树树树树树树树树水水水水树树树树树道道道道道道道道垣土土土土垣道道道道道道道道道道道道道道道橋橋橋土土土土树土树土树土树树树树树树树树树树
树树树树树树树树树树树水水水水树树树树树垣垣垣垣垣垣垣垣垣土土土土垣垣垣垣垣垣水水水水水水水水水水水水水土土土土草土草土草土树树树树树树树树树树
树树树树树树树树树树树水水水水树树树树树树树树石石树树树树土土土土土土草草树树水水水水水水水水水水水水水土土土土土树土树土树树树树树树树树树树树
树树树树树树树树树树树水水水水树树树树树树树树石石树树树树土土土土土土草草树树水水水水水水水水水水水水水土土土土土土土草土树树树树树树树树树树树
树树树树树树树树树树树水水水水树树树树树树树树石石石石草草土土土土飾土草草树树水水水树树树树树树树稂稂土土土土土土土土土树树树树树树树树树树树树
树树树树树树树树树树树水水水水树树树树树树树树石石石石草草土土土土土土草草树树水水水树树树树树树树稂稂土土土土土土土土树树树树树树树树树树树树树
树树树树树树树树树树树水水水水树树树树树树树树树树树树草草草草土土草草草草石石水水水树树树树树树树稂稂土土草草草草草草草树树树树树树树树树树树树
树树树树树树树树树树树水水水水树树树树树树树树树树树树草草草草土土草草草草石石水水水树树树树树树树稂稂土土草草草草草草草树树树树树树树树树树树树
树树树树树树树树树树树水水水水树树树树树树树树树树树树树树草草土土树树石石石石水水水树树树树树树树土土土土草草草草草草草树树树树树树树树树树树树
树树树树树树树树树树树水水水水树树树树树树树树树树树树树树草草土土树树石石石石水水水树树树树树树树土土土土草草草草草草草树树树树树树树树树树树树
树树树树树树树树树树树水水水水树树树树树树树树树树树树树树草草草草水水水水水水水水水树树树树树树树土土稂稂稂稂稂稂稂稂稂树树树树树树树树树树树树
树树树树树树树树树树树水水水水树树树树树树树树树树草草草草草草草草水水水水水水水水水树树树树树树树土土稂稂稂稂稂稂稂稂稂树树树树树树树树树树树树