無無無無無無無無無無無無無無無無無無無無無無無無無無無無無無無無無無無無無無無無無無無
無無無無無無無無無無無無無無無無無無無無無無無無無無無無無無無無無無無上無無無無無無無
無無無無無無無無無無無無無無無無無無無無無無無無無無無無無無無無無無道道道無無無無無無
無無無無無無無無無無無無無無無無無無無無無無無無無無無無無道道道道道道土道道道道道道無
無無無無無上無無無無無無無無無無無無無無無無無無無無無無無道道道道道道道道道道道道道無
無道道道道道道道道道無無無無無無無無無無無無無無無無無無無道土道無無無道無無無道土道無
無道道道道土道道道道無無無無無無無無無無無無無無無無無無無道道道無道道道道道無道道道無
無道道道道道道道道道無無無無無無無無無無無無無無無無無無無無無無無道土道土道無無無無無
無土道土道土道土道土無無無無無無無無無無無無無無無無無無無道道道無道道道道道無道道道無
無道道道道道道道道道無無無無無無無無無無無無無無無無無無無道土道無無無道無無無道土道無
無無無無無下無無無無無無無無無無無無無無無無無無無無無無無道道道道道道道道道道道道道無
無無無無無無無無無無無無無無無無無無無無無無無無無無無無無道道道道道道道道道道道道道無
無無無無無無無無無無無無無無無無無無無無無無無無無無無無無無無無無無道道道無無無無無無
無無無無無無無無無無無無無無無無無無無無無無無無無無無無無無無無無無無下無無無無無無無
無無無無無無無無無無無無無無無無無無無無無無無無無無無無無無無無無無無無無無無無無無無
無無無無無無無無無無無無無無無無無無無無無無無無無無無無無無無無無無無無無無無無無無無
無無無無無無無無無無無無無無無無無無無無無無無無無無無無無無無無無無無無無無無無無無無
無無無無無無無無無無無無無無無無無無無無無無無無無無無無無無無無無無無無無無無無無無無
無無無無無無無無無無無無無無無無無無無無無無無無無無無無無無無無無無無無無無無無無無無
無無無無無無無無無無無無無無無無無無無無無無無無無無無無無無無無無無無無無無無無無無無
無無無無無無無無無無無無無無無無無無無無無無無無無無無無無無無無無無無無無無無無無無無
水水水水水水水水水水水水水水水水水水水水水水上無無無無無無無無無無無無無無無無無無無無
土土土土土李土土土土土土土土李土土土花李土华花無無無無無無無無無無無無無無無無無無無無
水水水水水水水水水水水水水水水水水水华水水水李無無無無無無無無無無無無無無無無無無無無
無無無無無無無無無無無無無無無無無無土水土水土無無無無無無無無無無無無無無無無無無無無
無無無無無無無無無無無無無無無無無無李水华水华水水水水水水水水水水水水水水水水水水水水
無無無無無無無無無無無無無無無無無無花华土李花土土土李土土土土土土土土李土土土土土土土
無無無無無無無無無無無無無無無無無無下水水水水水水水水水水水水水水水水水水水水水水水水