树树树树树树树树树树树树树树树树树树树树树道無道道道道無無無無無無無道树树草草树树树树树树树树树树树树树树树树树树树树树树树树树树树树树树树树树
树树树树树树树树树树树树树树树树树树树树树道無道道道道道道道道道道無道树树草草树树树树树树树树树树树树树树树树树树树树树树树树树树树树树树树树树
树树树树树树树树树树树树树树树树树树树树树道無道道道道道道道道道道無道树树草草树树树树树树树树树树树树树树树树树树树树树树树树树树树树树树树树树
树树树树树树树树树树树树树树树树树树树树树道無道道道道道道道道道道無道树树草草树树树树树树树树树树树树树树树树树树树树树树树树树树树树树树树树树
树树树树树树树树树树树树树树树树树树树树树道無道道道道道道道道道道無道树树草草树树树树树树树树树树树树树树树树树树树树树树树树树树树树树树树树树
树树树树树树树树树树树树树树树树树树树树树道無無無無無無無道道道道無道树树草草树树树树树树树树树树树树树树树树树树树树树树树树树树树树树树树树树
道道树树树树树树树树树树树树树树树树树树树土土土土水水水水道道道道無道树树草草树树树树树树树树树树树树树树树树树树树树树树树树树树树树树树树树树
道道道道树树树树树树树树树树树树树树树树树土土土土水水水水道道道道無道土土土土树树树树树树树树树树树树树树树树树树树树树树树树树树树树树树树树树
道道道道道道树树树树树树树树树树树树树树树土土土土水水水水道道道道無道土土土土树树树树树树树道道道道道道道道無树树树树树树树树树树树树树树树树树
道道道道道道道道树树树树树树树树树树树树树土土土土水水水水道道道道無道土土树树树树树树树树树道道道道道道道道無树树树树树树树树树树树树树树树树树
树树道道道道道道道水水水水水水水水水水水水水水水水水水水水道道道道無道土土树树树树树树树树树道道道道道道道道無树树树树树树树树树树树树树树树树树
树树树树道道道道道水水水水水水水水水水水水水水水水水水水水道道道道無無無無無無無無無無無無無無無道道道道道道無树树树树树树树树树树树树树树树树树
树树树树树道道道道水水水水水水水水水水水水水水水水水水水水道道道道無道道道飾飾飾飾道道道道道道無道道道道道道無树树树树树树树树树树树树树树树树树
树树树树树道道土土水水水水水水水水水水水水水水水水水水水水道道道飾無飾飾飾無無無無道道道道道道無道道道道道道無树树树树树树树树树树树树树標树树树
树树树树树道道土土水水水水無無無無飾飾飾飾無無無無飾飾飾無道道道道無無無無道道道道道飾飾飾飾飾無道道道道道道無树树树树树树树树道道道道道道道道道
树树树树树道道土土水水水水無飾飾飾無無無無飾飾飾道無無無無無道道無無飾飾飾飾道道道道無無無無無無道道道道道道無树树草草草草树树道道道道道道道道道
树树树树树道道土土水水水水無無無無飾飾飾飾無無無飾飾飾飾無花花花花無無無無無道道道道道道道道道無無無無無無無無树树草草草草树树道道树树树树树道道
树树树树树道道土土水水水水無道道道無無無無道道道無無無無無花花花花道道道道道道道道道道道道道道道道道道道道道道無道道道道道道道道道树树树树树道道
树树树树树道道土土水水水水無道道道道道道道道道道道道飾飾無花花花花道道道道道道道道道道道道道道道道道道道道道道無道道道道道道道道道树树树树树標道
树树树树树道道土土水水水水無道無無無無道道飾飾飾飾道無無無花花花花無道道道道道飾飾飾飾飾飾道道無無無無無無無無树树树树树树树树树树树树树树树道道
树树树树树道道土土水水水水無道無無無無道道無無無無道道道無花花花花飾飾無無道道無無無無無無道道無道道道道道道無树树树树树树树树树树树树树树树道道
树树树树树道道道道水水水水無道無無無無飾飾道道飾飾飾飾道無花花花花無無道道道道土土土土土土飾飾飾飾道道道道道無树树树树树树树树树树树树树树树道道
树树树树树道道道道水水水水無道無無無無無無道道無無無無道無花花花花無道道道道道土土土土土土無無無無道道道道道無树树树树树树树树树树树树树树树草草
树树树树树道道土土水水水水無道無無無無飾飾飾飾飾飾飾飾飾飾花花花花飾飾飾飾飾飾土土土土飾飾飾飾道道道道道道道無树树树树树树树树树树树树树树树草草
树树树树树道道土土水水水水無道無無無無無無门無無無飾飾飾飾花花花花飾飾飾飾飾飾土土土土無门無無道道道道道道道無树树树树树树树树树树树树树树树树树
树树树树树道道土土水水水水無道無無無無道飾道道道道無無無無花花花花無無無無無無無無無無道道無無道道道道道道道無树树树树树树树树树树树树树树树树树
树树树树树道道土土水水水水無道無無無無道道道道飾道無门無無花花花花無無门無無無道道道道道道道無道道道道道道道無树树树树树树树树树树树树树树树树树
树树树树树道道土土水水水水無道無無無無花花花花花花花花花花花花花花花花花花花花道道飾飾飾飾飾飾道道道道道道道無树树树树树树树树树树树树树树树树树
树树树树树道道土土水水水水無道無無無無花花花花花花花花花花花花花花花花花花飾花道道無無無门無無道道道道道道道無树树树树树树树树树树树树树树树树树
树树树树树道道土土水水水水無道無無無無飾飾飾飾飾飾道道道道花花花花道道道道道道道道道道道道道無道道道道道道道無树树树树树树树树树树树树树树树树树
树树树树树道道土土水水水水無道無無無無飾飾飾飾飾飾無無無無花花花花無無無無無無無無無無無無無無無無無無無無無無树树树树树树树树树树树树树树树树树
树树树树树道道土土水水水水無道無無無無無無無無無無道道道道道道道道道道飾飾飾飾道道道道道道道道道道道道道道道道树树树树树树树树树树树树树树树树树
树树树树树道道土土水水水水無道無無無無無门無無無無道道道道道道道道道道飾飾飾飾道道道道道道道道道道道道道道道道树树树树树树树树树树树树树树树树树
树树树树树道道土土水水水水無道無無無無道道飾道無無無無無無花花花花無無無無無無飾飾飾飾無無飾飾飾飾無無無無無無树树树树树树树树树树树树树树树树树
树树树树树道道土土水水水水無道無门無無道道道道道道道道道道花花花花道道無無無無無無無無道道飾飾飾飾树树树树树树树树树树树树树树树树树树树树树树树
树树树树树道道道道道道道道花花花花花花花花花花花花花花花花花花花花花花花花花花花花花花花花無無無無树树树树树树树树树树树树树树树树树树树树树树树
树树树树树道道道道道道道道花花飾花花花花花花花花花花花花花花花花花花花花花花花花花花花花花無無無無树树树树树树树树树树树树树树树树树树树树树树树
树树树树树土土土土水水水水無道道道道道道道道道飾飾飾飾飾飾花花花花飾道飾飾飾飾道道道道飾飾飾飾道道树树树树树树树树树树树树树树树树树树树树树树树
树树树树树土土土土水水水水無無無無道道道道道道飾飾飾飾飾飾花花花花道道無無無無道道道道無無無無道道树树树树树树树树树树树树树树树树树树树树树树树
树树树树树树树树树水水水水水水水水飾飾飾飾飾飾無無無無無無花花花花飾飾飾飾飾飾道道飾飾飾飾道道飾飾树树树树树树树树树树树树树树树树树树树树树树树
树树树树树树树树树水水水水水水水水無無無無無無無無门無無無花花花花飾飾飾飾飾飾道道無门無無道道無無树树树树树树树树树树树树树树树树树树树树树树树
树树树树树树树树树水水水水水水水水飾飾道道道道道道道道道道花花花花無無無無無無道道道道道道飾飾飾飾树树树树树树树树树树树树树树树树树树树树树树树
树树树树树树树树树水水水水水水水水無無道道道道道道道道道道花花花花無無無無無無道道道道道道無無無無树树树树树树树树水水水水水水水水水水水水水水水
树树树树树树树树树水水水水無無飾飾飾飾道道飾飾飾飾飾飾飾飾花花花花無無無無無無飾飾飾飾道道道飾飾飾树树树树树树树树水水水水水水水水水水水水水水水
树树树树树树树树树水水水水無道無门無無道道無無無無飾飾飾飾花花花花無無無無無無無無無無道道道無無無树树树树树树树树水水水水水水水水水水水水水水水
树树树树树树树树树水水水水無道道道道道道道道道道道無無無無花花花花無無無無無無飾飾飾飾道道飾飾道道树树树树树树树树水水水树树树树树树树树树树树树
树树树树树树树树树水水水水無道道道道道道道道道道道無门無無花花花花無無门無無無飾飾飾飾道道無無道道树树树树树树树树水水水树树树树树树树树树树树树
树树树树树树树树树水水水水飾飾飾飾飾飾道道飾飾飾飾花花花花花花花花花花花花花花無無無無道道道飾飾飾树树树树树树树树水水水树树树树树树树树树树树树
树树树树树树树树树水水水水無無無無無無道道無门無無花花花花花花花花花花花花花花無门無無道道道無無無水水水水水水水水水水水树树树树树树树树树树树树
树树树树树树树树树水水水水水水飾飾道道道道道道道道飾飾飾飾花花花花道道道道飾飾飾道道道道飾飾飾飾飾水水水水水水水水水水水树树树树树树树树树树树树
树树树树树树树树树水水水水水水無無道道道道道道道道無無無無花花花花道道道道無無道道道道道無無無無無水水水水水水水水水水水树树树树树树树树树树树树
树树树树树树树树树树树水水水水道道飾飾飾飾飾飾飾飾道道飾飾花花花花飾飾飾飾道飾飾飾飾飾飾飾飾飾道道水水水树树树树树树树树树树树树树树树树树树树树
树树树树树树树树树树树水水水水道道無無無無無無無無道道無無花花花花無無無無道無無無無無無無無無道道水水水树树树树树树树树树树树树树树树树树树树树
树树树树树树树树树树树水水水水飾飾道道道飾飾飾無無無無無無花花花花無無無無飾飾飾飾飾飾道道飾飾飾飾水水水树树树树树树树树树树树树树树树树树树树树
树树树树树树树树树树树水水水水無無道道道無無無道道道道道無花花花花飾飾飾道飾飾飾飾無無道道無门無無水水水土土土土土土土土树树树树树树树树树树树树
树树树树树树树树树树树水水水水树树树树树道道道道道道道道無道道道道無無無道無無無無道道道道道道道道水水水土土土土土土土土土树树树树树树树树树树树
树树树树树树树树树树树水水水水树树树树树道道道道道道道道無道道道道無飾飾飾無门無無飾飾飾飾道道道道水水水土土土土土土土土土树树树树树树树树树树树
树树树树树树树树树树树水水水水树树树树树道道道道道道道道無土土土土無無無無道道道道無门無無道道道道道道道土土土土土土土土土树树树树树树树树树树树
树树树树树树树树树树树水水水水树树树树树道道道道道道道道無土土土土無道道道道道道道道道道道道道道道道道道土土土土土土土土土树树树树树树树树树树树
树树树树树树树树树树树水水水水树树树树树無無無無無無無無無土土土土無無無無無無水水水水水水水水水水水水水土土土土土土土土土树树树树树树树树树树树
树树树树树树树树树树树水水水水树树树树树树树树石石树树树树土土土土土土草草树树水水水水水水水水水水水水水土土土土土土土土土树树树树树树树树树树树
树树树树树树树树树树树水水水水树树树树树树树树石石树树树树土土土土土土草草树树水水水水水水水水水水水水水土土土土土土土土树树树树树树树树树树树树
树树树树树树树树树树树水水水水树树树树树树树树石石石石草草土土土土飾土草草树树水水水树树树树树树土土土土土土土土土土土土树树树树树树树树树树树树
树树树树树树树树树树树水水水水树树树树树树树树石石石石草草土土土土土土草草树树水水水树树树树树树土土土土土土土土土土土树树树树树树树树树树树树树
树树树树树树树树树树树水水水水树树树树树树树树树树树树草草草草土土草草草草石石水水水树树树树树树土土草草草草草草草草草草树树树树树树树树树树树树
树树树树树树树树树树树水水水水树树树树树树树树树树树树草草草草土土草草草草石石水水水树树树树树树土土草草草草草草草草草草树树树树树树树树树树树树
树树树树树树树树树树树水水水水树树树树树树树树树树树树树树草草土土树树石石石石水水水树树树树树树土土草草草草草草草草草草树树树树树树树树树树树树
树树树树树树树树树树树水水水水树树树树树树树树树树树树树树草草土土树树石石石石水水水树树树树树树土土草草草草草草草草草草树树树树树树树树树树树树
树树树树树树树树树树树水水水水树树树树树树树树树树树树树树草草草草水水水水水水水水水树树树树树树土土草草草草草草草草草草树树树树树树树树树树树树
树树树树树树树树树树树水水水水树树树树树树树树树树草草草草草草草草水水水水水水水水水树树树树树树土土草草草草草草草草草草树树树树树树树树树树树树