無無無無無無無上無無無無無無無無無無無無無無無無無無無無無無無無無無無上無無無無無無無
無無寺寺寺無寺寺寺無寺寺寺無無無無無無無無無無無無無無無無無草草草無草土土無草草草無無
無無寺寺寺寺寺寺寺寺寺寺寺無無無無無無無無無無無無無無無無無草草草草草土土土土草草無無
無無寺寺寺無寺寺寺無寺寺寺無無無無無無無無無無無無無無無無無草草草無草土土無土土草無無
無無無寺無無無無無無無寺無無無無無無無無無無無無無無無無無無無草無無無土無無無土無無無
無無寺寺寺無無無無無寺寺寺無無無無無無無無無無無無無無無無無草草土無土土土無土土土無無
無無寺寺寺無無無無無寺寺寺無無無無無無無無無無無無無無無無無土土土土土土土土土草草無無
無無寺寺寺無無無無無寺寺寺無無無無無無無無無無無無無無無無無土土土無土土土無草草草無無
無無無寺無無無無無無無寺無無無無無無無無無無無無無無無無無無無土無無無土無無無草無無無
無無寺寺寺無寺寺寺無寺寺寺無無無無無無無無無無無無無無無無無草土土無土土土無草草草無無
無無寺寺寺寺寺寺寺寺寺寺寺無無無無無無無無無無無無無無無無無草草土土土土土土草草草無無
無無寺寺寺無寺寺寺無寺寺寺無無無無無無無無無無無無無無無無無草草土無土土土無草草土無無
無無無無無無無下無無無無無無無無無無無無無無無無無無無無無無無無無無無下無無無無無無無
無無無無無無無無無無無無無無無無無無無無無無無無無無無無無無無無無無無無無無無無無無無
無無無無無無無無無無無無無無無無無無無無無無無無無無無無無無無無無無無無無無無無無無無
無無無無無無無無無無無無無無無無無無無無無無無無無無無無無無無無無無無無無無無無無無無
無無無無無無無無無無無無無無無無無無無無無無無無無無無無無無無無無無無無無無無無無無無
無無無無無無無無無無無無無無無無無無無無無無無無無無無無無無無無無無無無無無無無無無無
無無無無無無無無無無無無無無無無無無無無無無無無無無無無無無無無無無無無無無無無無無無
無無無無無無無無無無無無無無無無無無上無無無無無無無無無無無無無無無無無無無無無無無無
土土土土土土土土土土土土土土土土土土土土土土土土土土土土土土土土土土土土土土土土土土土
水水水水水水水水水水水水水水水水水水土水水水水水水水水水水水水水水水水水水水水水水水水
水水水水水水水水水水水水水水水水水水土水水水水水水水水水水水水水水水水水水水水水水水水
土土土土土土土土土土土土土土土土水水土水水土土土土土土土土土土土土土土土土土土土土土土
水水水水水水水水水水水水水水水水水水土水水水水水水水水水水水水水水水水水水水水水水水水
水水水水水水水水水水水水水水水水水水土水水水水水水水水水水水水水水水水水水水水水水水水
土土土土土土土土土土土土土土土土土土土土土土土土土土土土土土土土土土土土土土土土土土土
無無無無無無無無無無無無無無無無無無下無無無無無無無無無無無無無無無無無無無無無無無無