树树树树树树树树树树树树树树┫水水水水树树树垣道道道道垣垣垣垣垣垣垣道树树草草树树树树树树树树树树树树树树树树树树树树树树树树树树树树树树树树树
树树树树树树树树树树树树树树┫水水水水树树树垣道道道道道道道道道道垣道树树草草树树树树树树树树树树树树树树树树树树树树树树树树树树树树树树树树树
树树树树树树树树树树树树树树┫水水水水树树树垣道道道道道道道道道道垣道树树草草树树树树树树树树树树树树树树树树树树树树树树树树树树树树树树树树树
树树树树树树树树树树树树树树┫水水水水水水水水水水水水水水道道道道垣道树树草草树树树树树树树树树树树树树树树树树树树树树树树树树树树树树树树树树
树树树树树树树树树树树树树树┫水水水水水水水水水水水水水水道道道道垣道树树草草树树树树树树树树树树树树树树树树树树树树树树树树树树树树树树树树树
树树树树树树树树树树树树树树┫水水水水水水水水水水水水水水道道道道垣道树树草草树树树树树树树树树树树树树树树树树树树树树树树树树树树树树树树树树
树土土土树树树树树树树树树树┫水水水水水水┏┳┳┓水水水水道道道道垣道树树草草树树树树树树树树树树树树树树树树树树树树树树树树树树树树树树树树草
土土土土土树树树树树树树树树┳┳┲┲┱┱┳┳穴穴┫水水水水道道道道垣道土土土土树树树树树树树树树树树树树树树树树树树树树树树树树树树树树树树树草
土土土土土土土树树树树树树树树树┣┗┛┫穴穴穴穴┫水水水水道道道道垣道土土土土树树树树树树树树树树树树树树树树树树树树树树树树树树树树树树树树草
土土土土土土土土土土土土土土树树┗┻┻┛穴穴穴树┫水水水水道道道道垣道土土树树树树树树树树树树树树树树树树树树树树树树树树树树树树树树树树树树草
土土土土土土土土土土土土土土土土土穴穴穴穴树树树┫水水水水道道道道垣道土土树树树树树树树树树树树树树树树树树树树树树树树树树树树树树树树树树树草
土土土土土土土土土树草草树树树树树┌┻┻┻┻┻┻┛水水水水道道道道垣道土土树树树树树树树树树树树树树树树树树树树树树树树树树树树树树树树树树树树
土土土土树树树树树树草草树树树树树┫水水水水水水水水水水水道道道道垣树树树树树树树树树树树树树树树树树树树树树树树树树树树树树飾飾飾飾土土土土树
土树树树树树树树树树草稂稂树树树┌┛水飾飾水水水水水水水水道道道飾垣树树树树树树树树树树树树树树树树树树树树树树树树树树树树树無门無無土土土土树
树树树树树树树树树草草树稂树树┌┛水水無门水水水水飾水水水道道道道垣树树树飾飾飾飾树树树树树树树树树树树树树树树树树树树树树树道道道道道道道道道
树树树树树树树树稂稂稂树稂树树┫水水水水圯水水水飾飾飾水水垣道道垣垣树树树飾飾飾飾土土土树树树树树树树树树树稂草草草草草稂树树道道道道道道道道道
树树树树树树树树稂树稂稂稂树┌┛水飾飾水圯水土飾飾無飾飾土道道道道飾飾飾飾無無無無土土土树树树树树树树树树树稂草水水草草稂树树土土树树土土土土土
树树树树树树树稂稂稂稂草树┌┛水水無门水圯土仏飾無無無飾仏道道道道飾飾飾飾無门館無道道道道道道道道道土土土土稂草水树草水稂土土土土树树土土土土土
树树树树树树树稂树稂树草树┫水水水水圯水水土土無無门無無土道道道道無無無無道道道道道道道道道道道道道土土土土稂草草草草水稂土土土土树树土土土土土
树树树树树树树稂树稂草草树┫水水水水橋橋土土土土土道土土土道道道道無门買無道道道道道道土土土土水水水草草草草稂草水草草草稂草草树树树树稂树树树树
树树树树树树树稂稂稂草树┌┛水飾飾水水水土土土道道道道道道道道道道道道道道道道垣垣垣垣垣垣垣水水水水水草草草稂草草草草草稂草草树树稂稂稂树树树树
树树树树树树树草稂树稂树┫水水無门水水土土土道道飾飾飾飾道道道道道道道道道道道垣土土土花土土土水水水水水草草稂水草草水水稂草草树树稂水水树树树树
树树树树树树树草稂稂稂树┫水水水圯水水土土土道道無门無無道道道道道飾飾飾飾飾飾垣土树土土花土树土水水树树草草稂稂稂稂稂稂稂草草树树稂稂稂稂稂稂树
树树树树树树树草草树树┌┛水水水圯水土土土飾飾道道道飾飾飾道道道道飾飾飾飾飾飾垣土花土土树土土土李树树树草草草草草草草草草草草稂树树水稂水水稂树
树树树树树树树草草草树┫水水水水圯土土土土無無道道道無無無道道道道無無無無無無垣土土土土土土土土土稂稂树草草草草草草草草草草草稂稂树稂稂水稂稂树
树树树树树树树土土土┌┛水水水水土土土飾飾飾飾飾飾飾飾飾飾道道道道無無门競無無垣土土土土土树土李土树稂树树树树树树树树稂稂稂稂稂稂树水水水稂水树
树树树树树树树土土土┫水水水水水土树土無無门無無無飾無無飾道道道道道道道道道飾飾门飾土树土土土土土树稂稂树树树树稂稂树稂稂稂稂稂稂树树树树稂水水
树树树树树树树土土土┫水水水水土土土土土土土道道道無無無無道道道道道道道道道無门無無土李树土土树土树稂稂稂稂稂稂稂稂树树稂稂树树稂树稂树树稂稂稂
树树树树树树树土土土┫水水水水土土土土土土土道道道無门無無道道道道道道道道道道道树树土土土土土土土树树树树稂稂稂稂稂树稂稂稂树稂稂稂稂树树树树树
水水水树树树树土土土┫水水水土树土土土土飾飾飾道道道道道道道道道道道道道道道道树树树树树树树树树树树树稂树树稂树树稂稂稂稂稂树树树树树树树树树树
水水水树树树树土土土┫水水水土土土树土土無無無道道道道道道道道道道垣垣垣垣垣垣垣垣垣垣仏飾飾飾飾飾树树稂稂稂稂树树树树树树树树树树树树树树树树树
树水水土土树树土土土┫水水水土土土土土土土土飾飾飾飾飾飾飾道道道道垣道道道道道道道道垣仏飾飾飾飾飾树树树树树树树树树树树树树树树树树树树树树树树
树水水花土树树土土土┫水水水土土土土飾飾飾土無飾飾飾飾飾飾道道道道垣道道道道道道道道垣仏飾飾飾飾飾树树树树树树树树树树树树树树树树树树树树树树树
土橋橋土花树树土土土┫水水水土树土土無飾飾飾飾無無無無無無道道道道垣道道道道道道道道垣仏無门無無無树树树树树树树树树树树树树树树树树树树树树树树
树水水土土树树土土土┫水水水土土土土土無無無無無無门学無無道道道道道道垣垣垣垣垣道道道土土土仏树树树树树树树树树树树树树树树树树树树树树树树树树
树水水李树树树道道道─橋橋橋道道道道道道道道道道道道道道道道道道道垣道道道道道道道道垣土土土仏树树树树树树树树树树树树树树树树树树树树树树树树树
树水水土树树树道道道─橋橋橋道道道道道道道道道道道道道道道道道道道垣道道道道道道道道垣树树树树树树树树树树树树树树树树树树树树树树树树树树树树树
树水水树树树树道道土┫水水水土土土土土土土土道飾飾飾飾道道飾飾飾飾垣道道道道道道道道垣树树树树树树树树树树树树树树树树树树树树树树树树树树树树树
┻滝滝┻┻┻┻║║┻┛水水水土土土土土树土土道飾無無飾道道無门無無垣飾飾飾飾垣垣垣垣垣树树树树树树树树树树树树树树树树树树树树树树树树树树树树树
树水水水水水水圯圯水水水水水土土土土土土土土道無無無無道道道道道飾飾飾無门無道飾飾飾飾树树树树树树树树树树树树树树树树树树树树树树树树树树树树树
树水水水水水水圯圯水水水水水土土飾飾土土土土道無门無無道道道道道無無無道道道道飾無無飾树树树树树树树树树树树树树树树树树树树树树树树树树树树树树
树树土土土土土道道土土水水水土飾飾飾飾土土土道道道道道道飾飾飾飾飾飾飾道飾飾飾無無無無树树树树树树树树树树树树树树树树树树树树树树树树树树树树树
树树土土土土土道道土土水水水土無無無無土土土土土道道道道無無飾飾飾飾飾道無無無無门無無树树树树树树树树树树树树树树水水水水水水水水水水水水水水水
┓树树土土土土道道土土水水水土無门無無土土土树土道道道道道道無無無無無道道道道道道道道树树树树树树树树树树树树树树水水水水水水水水水水水水水水水
┫树树土土土土道道土土水水水土土土土土土土土土土道飾飾飾飾道飾飾飾飾飾飾飾道道道道道道道道树树树树树树树树树树树树水水水水水水水水水水水水水水水
┳┓树树土土土道道土土水水水土土土土土土土土土土道無门無無道無飾無無無無無道道道道道道道道树树树树树树树树树树树树水水水树树树树树树树树树树树树
土┫树树树土土道道土土水水水土土土土土树土土土土道道道道道道道無树土土土飾飾飾飾土土土道道树树树树树树树树树树树树水水水树树树树树树树树树树树树
土┳┓树树土土道道土土水水水土土土土土土土土土土土道飾飾飾飾道道树土飾土飾飾飾飾土飾土道道树树树树树树树树树树树树水水水树树树树树树树树树树树树
土树┫树树树土道道土土水水水土土土土树土土土土土土道無门無無道道树土無土無無無無土無土道道道道道道水水水水水水水水水水水树树树树树树树树树树树树
土土─道道道道道道道道橋橋橋道道道道道道道道道道道道道道道道道道树土無無無门学無無無土道道道道道道水水水水水水水水水水水树树树树树树树树树树树树
土土─道道道道道道道道橋橋橋道道道道道道道道道道道道道道道道道道树土土土土道道土土土土道道树树道道水水水水水水水水水水水树树树树树树树树树树树树
树树┳┳┳┳┳┳┓树树水水水树树树土土土土土土土土土土土土土道道树土水水土道道道道道道道道树树道道水水水树树树树树树树树树树树树树树树树树树树树
草树树树树树树树┫树树水水水树树树土土土土土土土土土土土土土道道树土水水土道道道道道道道道树树道道水水水树树树树树树树树树树树树树树树树树树树树
草树树树树树树树┫树树水水水树树树土土土土土土土土树土土土土道道树土水水土土土土土土土土土树树道道水水水树草土草土草土草树树树树树树树树树树树树
草树树树树树树树┫树树水水水树树树树树树树树土土土土土土土土道道树土土土土土土土土土土土土树树道道水水水树土树土树土树土树树树树树树树树树树树树
草树树树树树树树┫树树水水水树树树树树树树树树树树树树树树树道道树树树树树树树树树树树树树树树道道水水水草土草土草土草土草树树树树树树树树树树树
草树树树树树树树┳┓树水水水树树树树树树树树树树树树树树树树道道树树树树树树树树树树树树树树树道道水水水土树土树土树土树土树树树树树树树树树树树
草树畑畑畑畑畑畑树┫树水水水树树树树树树树树树树树树树树树土道道土土土草草草草树树树树树树树树道道橋橋橋土土土草土草土草土草树树树树树树树树树树
草树畑畑畑畑畑畑树┫树水水水树树树树树树树树树树树树树树树土土土土土土草草草草树树树树树树树树道道橋橋橋土土土土树土树土树土树树树树树树树树树树
树树畑畑畑畑畑畑树┫树水水水树树树树树树树树树树树树树树树土土土土土土草草草草水水水水水水水水水水水水水土土土土草土草土草土树树树树树树树树树树
飾飾畑畑畑畑畑畑树┫树水水水树树树树树树树树树石石树树树树土土土土土土草草草草水水水水水水水水水水水水水土土土土土树土树土树树树树树树树树树树树
门無畑畑畑畑畑畑树┫树水水水树树树树树树树树树石石树树树树土土土土土土草草草草水水水水水水水水水水水水水土土土土土土土草土树树树树树树树树树树树
土土畑畑畑畑畑畑树┫树水水水树树树树树树树树树石石石石草草土土土土土土草草草草水水水树树树树树树树稂稂土土土土土土土土土树树树树树树树树树树树树
土土畑畑畑畑畑畑树┳┓水水水水树树树树树树树树石石石石草草土土土土土土草草草草水水水树树树树树树树稂稂土土土土土土土土树树树树树树树树树树树树树
草草树树树树树树树树┫水水水水树树树树树树树树树树树树草草草草土土草草草草石石水水水树树树树树树树稂稂土土草草草草草草草树树树树树树树树树树树树
草草树树树树树树树树┫水水水水树树树树树飾飾飾飾树树树草草草草土土草草草草石石水水水树树树树树树树稂稂土土草草草草草草草树树树树树树树树树树树树
草草树树树树树树树树┫水水水水树树树树树無门無無树树树树树草草土土树树石石石石水水水树树树树树树树土土土土草草草草草草草树树树树树树树树树树树树
草草树树树树树树树树┫水水水水树树树树树土土土土树树树树树草草土土树树石石石石水水水树树树树树树树土土土土草草草草草草草树树树树树树树树树树树树
树树树树树树树树树树┫水水水水树树树树树树土土树树树树树树草草草草水水水水水水水水水树树树树树树树土土稂稂稂稂稂稂稂稂稂树树树树树树树树树树树树
树树树树树树树树树树┫水水水水草草草草草草土土树树草草草草草草草草水水水水水水水水水树树树树树树树土土稂稂稂稂稂稂稂稂稂树树树树树树树树树树树树
