树树树树树树树树树树树土土树树树树树树树树树树树树树树树树树树树树树树树树树树树树树树树树树树┫水水水水水水
树树树树树树树树树树树土土树树树树树树树树树树树树树树树树树树树树树树树树树树树树树树树树树树┳┳┳┳┓水水
树树树树树树树树树树树土土树树树树树树树树树树树树树树树树树树树树树树树树树树树树树树树树树树树树树树┫水水
树树树树树树树树树树树土土树树树树树树树树树树树树树树树树树树树树树树树树树树树树树树树树树树树树树树┫水水
树树树树树树树树树树树土土树畑畑畑畑畑畑畑树树树树树树树树树树树树树树树树树树树树树树树树树树树树树树┫水水
树树树树树树树树树树树土土树畑畑畑畑畑畑畑树树树树树树树树树树树树树树树树树树树树树树树树树树树树树树┫水水
树树树树树树树树树树树土土树畑畑畑畑畑畑畑树树树树树树树树树树树树树树树树树树树树树树树树树树树树树树┫水水
树树树树树树树树树树树土土树畑畑畑畑畑畑畑树树树树树树树树树树树树树树树树树树树树树树树树树树树树树树┫水水
树树树树树树树树树树树土土树畑畑畑畑畑畑畑树树树树树树树树树树树树树树树树树树树树树树树树树树树树树树┫水水
树树树树树树树树树树树土土树畑畑畑畑畑畑畑树树树树树树树树树树树树树树树树树树树树树树树树树树树树树树┫水水
树树树树树树树树树树树土土树树飾飾飾飾土树树树树树树树树树树树树树树树树树树树树树树树树树树树树树树树┫水水
树树树树树树树树树树树土土树树無门無無土树树树树树树树树树树树树树树树树树树土土土树树树树树树树树树树┫水水
树树树树树树树树土土土土土土土土土土土土树树树树土土土土土树树树树树树树土土土門土土树树树树树树树树树┳┳┲
树树树树树树树土土土土土土水水水水水水水水水水土土土土土土土树树树树树土土土土土土土土土树树树树树树树树树┣
树树树树树树树土土土土土土水水水水水水水水水水土土土土土土土树树树树树土土土土土土土土土土土土土土土土树树┗
水水水水水水水水土土土土土水水土土土土土土水水土土土土土土土土树树树树土土土土土土土土土土土土土土土土土土土
水水水水水水水水土土土土土橋橋土土土土土土水水水圯水水土土土土土树树树土土土土土土土土土土土树草草树树树树树
树树树树树树水水土土土土土水水土土土土土土水水水圯水水土土土土土土土土土土土土土土树树树树树树草草树树树树树
树树树树树树水水圯水水水水水水土土土土土土土土土土水水土土土土土土土土土土土树树树树树树树树树草稂稂树树树┌
树树树树树树水水圯水水水水水水树土土土土土土土土土水水土土土土土土树树树树树树树树树树树树树草草树稂树树┌┛
树树树树树树树树土飾飾飾飾树树树树土土土土土土土土水水水水土土土土树树树树树树树树树树树树稂稂稂树稂树树┫水
树树树树树树树土土無门無無树树树树树土土土土土土土水水水水土土土树树树树树树树树树树树树树稂树稂稂稂树┌┛水
树树树树树树树土土土土土树树树树树树树土土土树树树树树水水土土土树树树树树树树树树树树树稂稂稂稂草树┌┛水水
树树树树树树树土土土土树树树树树树树树树树草树树树树树水水圯水水树树树树树树树树树树树树稂树稂树草树┫水水水
树树树树树树树畑畑畑畑畑畑畑畑树树树树树草草树树树树树水水圯水水树树树树树树树树树树树树稂树稂草草树┫水水水
树树树树树树树畑畑畑畑畑畑畑畑树树树树树草草树树树树土土土土水水树树树树树树树树树树树树稂稂稂草树┌┛水飾飾
树树树树树树树畑畑畑畑畑畑畑畑树稂稂稂树草草树树树飾飾飾飾土水水树树树树树树树树树树树树草稂树稂树┫水水無门
树树树树树树树畑畑畑畑畑畑畑畑稂稂树稂稂草草树树树無门無無土水水树树树树树树树树树树树树草稂稂稂树┫水水水圯
树树树树树树树树稂树树树树树树树树树稂草树草树树树土土土土土水水树树树树树树树树树树树树草草树树┌┛水水水圯
树树树树树树树树稂稂树树树树树草草草草草稂稂树树树树土土土土水水树树树树树树树树树树树树草草草树┫水水水水圯
树树树树树树树树無稂稂树树树草草树草树稂稂树树树树树树树树草水水树树树树树树树树树树树树土土土┌┛水水水水土
树树树树树树树無無無稂稂树树草树稂稂树草树树树树树树树树树草水水树树树树树树树树树树树树土土土┫水水水水水土
树树树树树树無無门無無稂稂树草草稂草草草树树树稂稂稂树稂稂草水水水水水树树树树树树树树树土土土┫水水水水土土
树树树树树树树稂稂稂稂树稂草草草草草树稂稂稂稂稂树稂树稂树树水水水水水树树树树树树树树树土土土┫水水水水土土
树树树树树树树稂树树稂稂稂树草树树草树树树稂树稂树稂稂稂稂稂稂树树水水水水水水水树树树树土土土┫水水水土树土
树树树树树树树稂稂树树稂稂稂稂稂草草稂稂稂稂树稂树稂树树树树草草草水水水水水水水树树树树土土土┫水水水土土土
树树树树树树树树稂稂稂稂稂树树稂树稂树树稂稂稂稂稂稂树树树树树树草树树树树树水水土土树树土土土┫水水水土土土
树树树树树树树树稂树無树稂稂稂稂树稂稂树树树树稂树树树树稂稂稂草草树树土花树水水花土树树土土土┫水水水土土土
树树树树树树树稂稂無無無树稂树树树树稂稂稂稂稂稂树树稂稂稂树树树树树土土土土橋橋土花树树土土土┫水水水土树土
树树树树树树树稂無無门無無稂稂稂稂树树树稂树树树树树稂树稂稂草草草草花土土树水水土土树树土土土┫水水水土土土
树树树树树树树稂稂稂稂稂稂稂树树稂稂稂稂稂稂稂稂稂稂稂树树树树树树树土土树树水水李树树树道道道─橋橋橋道道道
树树树树树树树树树树树树树树树树树树树树树树树树树树树树树树树树树树树树树树水水土树树树道道道─橋橋橋道道道
树树树树树树树树树树树树树树树树树树树树树树树树树树树树树树树树树树树树树树水水树树树树道道土┫水水水土土土
树树树树树树树树树树树树树树树树树树树树树树树树树树树树树树树树树树树树┌┻滝滝┻┻┻┻║║┻┛水水水土土土
树树树树树树树树树树树树树树树树树树树树树树树树树树树树树树树树树树树树┫树水水水水水水圯圯水水水水水土土土
