水水树树树树树树树树树树树树树树树树树树树树树树土土土土土土土土土土土树树树树树树树树垣道土水水水华水土道無门無無道道道道道飾飾飾飾道
水水树树树树树树树树树树树树树树树树树树树树树树土土土土土土土土土土土树树树树树树树树垣道土土土土土土土道道道道道道道道道道無门無無道
树树树树树树树树树树树树树树树树树树树树树树树树树树树树树树树树树树树树树树树树树树树垣道道道道道道道道道道道道道垣道道垣道道道道道道
树树树树树树树树树树树树树树树树树树树树树树树树树树树树树树树树树树树树树树树树树树树垣垣垣垣垣垣垣垣垣垣垣垣垣垣垣道道垣垣垣垣垣垣垣
树树树树树树树树树树树树树树树树树树树树树树树树树树树树树树树树树树树树树树树树树树水水水水水水水水水水水水水水水水圯圯水水水水水水水
树树树树树树树树树树树树树树树树树树树树树树树树树树树树树树树树树树树树树树树树树树水水水水水水水水水水水水水水水水圯圯水水水水水水水
树树树树树树树树树树树树树树树树树树树树树树树树树树树树树树树树树树树树树树树树树树水水树树树树树树树树树树树树树树土土树树树树树树树
树树树树树树树树树树树树树树树树树树树树树树树树树树树树树树树树树树树稂稂稂稂稂树树水水树树树树树树树树树树树树树树土土树树树树树树树
树树树树树树树树树树树树树树树树树树树树树树树树树树树树树树树树树树稂稂树稂树稂稂树水水树树树树树树土土土土土土土土土土树树树树树树树
树树树树树树树树树树树树树树树树树树树树树树树树树树树树树树树稂稂稂稂树树稂稂稂稂稂水水树树树草草草土土土土土土土土土土树树树树树树树
树树树树树树树树树树树树树树树树树树树树树树树树树树树树树树树稂稂树稂稂稂稂稂稂稂稂橋橋草草树草树树土土草草草草草草草草树树树树树树树
树树树树树树树树树树树树树树树树树树树树树树树树树树树树树树树稂树稂稂稂稂稂稂稂稂稂水水树草树草树树土土草草草草草草草草树树树树树树树
树树树树树树树树树树树树树树树树树树树树树树树树树树树树树树稂稂稂稂稂稂稂稂稂稂稂树水水树草草草树树土土草草草草水水水水树树树树树树树
树树树树树树树树树树树树树树树树树树树树树树树树树树树树树树稂稂稂稂稂稂稂稂稂稂树树水水树树树树树树土土草草草草水水水水树树树树树树树
树树树树树树树树树树树树树树树树树树树树树树树树树树树树树稂稂稂稂稂树稂稂树树树树树水水树树树树树树土土树树树树树树树树树树树树树树树
树树树树树树树树树树树树树树树树树树树树树树树树树树树树树稂稂稂稂稂稂稂树树土土土土橋橋土土土土土土土土飾飾飾飾树树社树树树树树树树树
树树树树树树树树树树树树树树树树树树树树树树树树树树树树树树稂稂稂稂稂稂树树土土土土橋橋土土土土土土土土無门無無树畑畑畑树树树树树树树
树树树树树树树树树树树树树树树树树树树树树树树树树树树树树树稂稂树稂树稂树树土土水水水水草草草草草草土土土土土畑畑畑畑畑树树树树树树树
树树树树树树树树树树树树树树树树树树树树树树树树树树树树树树稂稂稂稂稂稂树树土土水水水水草草草草草草土土土土土畑树畑树畑树树树树树树树
树树树树树树树树树树树树树树树树树树树树树树树树树树树树树树稂稂稂树稂树树树土土水水树树树树树树树树畑畑畑畑畑畑畑畑畑畑树树树树树树树
树树树树树树树树树树树树树树树树树树树树树树树树树树树树树树稂稂稂稂稂树树树土土水水树树树树树树树树畑树畑树畑树畑树畑树树树树树树树树
树树树树树树树树树树树树树树树树树树树树树树树树树树树树树树稂稂树稂树树树树土土水水树树树树树树树树畑畑畑畑畑畑畑畑畑畑树树树树树树树
树树树树树树树树树树树树树树树树树树树树树树树树树树树树树树草草草草草草草土土土水水树树树树树树树树树畑树畑树畑树畑树畑树树树树树树树
树树树树树树树树树树树树树树树树树树树树树树树树树树树树树树草草草草草草草土土土水水树树树树树树树树树畑畑畑畑畑畑畑畑畑树树树树树树树
树树树树树树树树树树树树树树树树树树树树树树树树树树树树树树草草草草草草草水水水水水树树树树树树树树树树树树树树树树树树树树树树树树树
树树树树树树树树树树树树树树树树树树树树树树树树树树树树树树草草草草草草草水水水水水树树树树树树树树树树树树树树树树树树树树树树树树树
树树树树树树树树树树树树树树树树树树树树树树树树树树树树树树草草草草草草草水水树树树树树树树树树树树树树树树树树树树树树树树树树树树树
树树树树树树树树树树树树树树树树树树树树树树树树树树树树树树草草草草草草草橋橋草草草草草草草草草树树树树树树树树树树树树树树树树树树树
树树树树树树树树树树树树树树树树树树树树树树树树树树树树树树草草草草草草草橋橋草草草草草草草草草树树树树树树树树树树树树树树树树树树树
树树树树树树树树树树树树树树树树树树树树树树树树树树树树树树树树树水水水水水水树树树草草草草草草树树树畑社畑树树树树树树树树树树树树树
树树树树树树树树树树树树树树树树树树树树树树树树树树树树树树树树树水水水水水水树树树草草草草草草树树树畑土畑树树树树树树树树树树树树树
树树树树树树树树树树树树树树树树树树树树树树树树树树树树树树树树树水水树树树树树树树草草草草草草树树树土土土树树树树树树树树树树树树树
树树树树树树树树树树树树树树树树树树树树树树树树树树树稂稂树树树树水水树树树树树草草草草草草树树树树树树土树树树树树树树树树树树树树树
树树树树树树树树树树树树树树树树树树树树稂稂稂稂稂稂稂稂稂水水水水水水树树树树树草草草草草草树树树树树土土树树树树树树树树树树树树树树
树树树树树树树树树树树树树树树树树树稂稂無稂稂稂稂稂稂稂稂水水水水水水树树树树树土土草草草草树树树树树土树树树树树树树树树树树树树树树
树树树树树树树树树树树树树树树树稂稂稂無無無稂稂稂稂稂稂稂橋橋稂稂稂稂树树树树树土土草草草草树树树树树土土土树树树树树树树树树树树树树
树树树树树树树树树树树树树树树稂稂稂無無门無無稂稂稂稂稂稂水水稂稂稂稂树树树树树土土树树树树树树树树树树树土树树树树树树树树树树树树树
树树树树树树树树树树树树树树树稂稂稂稂稂稂稂稂稂稂水水水水水水稂稂稂稂树树树树树土土树畑畑畑畑畑畑畑畑畑畑畑畑树树树树树树树树树树树树
树树树树树树树树树树树树树树稂稂稂稂稂稂稂稂稂稂稂水水水水水水稂稂稂稂树树树树树土土树畑畑畑畑畑畑畑畑畑畑畑畑树树树树树树树树树树树树
树树树树树树树树树树树树树树稂稂稂稂稂稂稂稂稂稂稂水水稂稂稂無稂稂稂稂树树树树树土土飾飾飾飾畑畑畑畑畑畑畑畑畑树树树树树树树树树树树树
树树树树树树树树树树树树树树稂稂稂稂稂稂稂稂稂稂稂水水稂稂無無無稂稂稂树树树树树土土無门無無畑畑畑畑畑畑畑畑畑树树树树树树树树树树树树
树树树树树树树树树树树树树稂稂稂稂稂稂稂稂稂稂稂稂水水稂無無门無無稂树树树树树树土土花土花土畑畑畑畑畑畑畑畑畑树树树树树树树树树树树树
树树树树树树树树树树树树树稂稂稂稂稂稂稂稂稂水水水水水稂稂稂稂稂稂稂树树树树树树土土土土土土畑畑畑畑畑畑畑畑畑树树树树树树树树树树树树
树树树树树树树树树树树树稂稂稂稂稂稂稂稂稂稂水水水水水稂稂稂稂稂稂树树树树树树树树树土土树树树树树树树树树树树树树树树树树树树树树树树
树树树水水水水水水水水水水水水水水水水水圯水水水树树树树树树稂稂树树树树树树树树树树土土树树树树树树树树树树树树树树树树树树树树树树树
树树树水水水水水水水水水水水水水水水水水圯水水水树树树树树树树树树树树草草草草草草草土土树树树树树树树树树树树树树树树树树树树树树树树
树树树水水树树树树树树树树树树树树树稂稂稂稂稂稂稂稂稂稂树树树树树树树草草草草草草草土土树树树树树树树树树树树树树树树树树树树树树树树
水水水水水树树树树树树树树树树树树树树稂稂稂稂稂稂稂稂稂草草草草草草草草草草土土土土土土树树树树树树树树树树树树树树树树树树树树树树树
水水水水水树树树树树树树树树树树树树树树稂稂稂稂稂稂稂稂草草草草草草草草草草土土土土土土树树树树树树树树树树树树树树树树树树树树树树树
水树树树树树树树树树树树树树树树树树树树树稂稂稂稂稂稂稂草草草草草草草草草草草草树树树树树树树树树树树树树树树树树树树树树树树树树树树
水树树树树树树树树树树树树树树树树树树树树稂稂稂稂稂稂稂草草草草草草草草草草草草树树树树树树树树树树树树树树树树树树树树树树树树树树树
水树树树树树树树树树树树树树树树树树树树树树树树树树树树草草草草草草树树树树树树树树树树树树树树树树树树树树树树树树树树树树树树树树树
树树树树树树树树树树树树树树树树树树树树树树树树树树树树草草草草草草树树树树树树树树树树树树树树树树树树树树树树树树树树树树树树树树树
树树树树树树树树树树树树树树树树树树树水水树树树树树树树树树土土树树树树树树树树社树树树树树树树树树树树树树树树树树树树树树树树树树树
树树树树树树树树树树树树树树树树树树树水水树树树树树树树树树土土树树树树树树树畑畑畑树树树树树树树树树树树树树树树树树树树树树树树树树
树树树树树树树树树树树树树树树树树树树水水树树树树树树树树树土土土土土土畑畑畑畑畑畑树树树树树树树树树树树树树树树树树树树树树树树树树
树树树树树树树树树树树树树树树树树树树水水树树树树树树树树树土土土土土土畑畑畑畑畑畑树树树树树树树树树树树树树树树树树树树树树树树树树
树树树树树树树树树树树树树树树树树树树水水水水水水水水水水水圯圯水水水水畑畑畑畑畑畑树树树树树树树树树树树树树树树树树树树树树树树树树
树树树树树树树树树树树树树树树树树树树水水水水水水水水水水水圯圯水水水水畑畑畑畑畑畑树树树树树树树树树树树树树树树树树树树树树树树树树
树树树树树树树树树树树树树树树树树树树树树树树树树树树树树树土土土土水水畑畑畑畑畑畑树树树树树树树树树树树树树树树树树树树树树树树树树
树树树树树树树树树树树树树树树树树树树树树树树树树树树树树树土土土土水水畑畑畑畑畑畑树树树树树树树树树树树树树树树树树树树树树树树树树
树树树树树树树树树树树树树树树树树树树树树树树树草草草草草草土土土土水水畑畑畑畑畑畑树树树树树树树树树树树树树树树树树树树树树树树树树
树树树树树树树树树树树树树树树树树树树树树树树树草草草草草草土土土土水水飾飾飾飾土土树树树树树树树树树树树树树树树树树树树树树树树树树
树树树树树树树树树树树树树树树树树树树草草草草草草草土土土土土土土土水水無门無無土土树树树树树树树树树树树树树树树树树树树树树树树树树
树树树树树树树树树树树树树树树树树树树草草草草草草草土土土土土土土土水水土土土土土土树树树树树树树树树树树树树树树树树树树树树树树树树
树树树树树树树树树树树树树树树树树树树飾飾飾飾土土土土土土花土花土花水水土土土土土土树树树树树树树树树树树树树树树树树树树树树树树树树
树树树树树树树树树树树树树树树树树树树無门無無土土土土土花土花土花土水水土土树树树树树树树树树树树树树树树树树树树树树树树树树树树树树
树树树树树树树树树树树树树树树树树树树土土土土土土土土土飾飾飾飾飾飾水水土土树树树树树飾飾飾飾飾飾树树树树树树树树树树树树树树树树树树
树树树树树树树树树树树树树树树树树树树土水水水水水水水土飾飾飾飾飾飾水水土土树树树树树飾飾飾飾飾飾树树树树树树树树树树树树树树树树树树
树树树树树树树树树树树树树树树树树树树土水水华水水水水土無無無無無無水水土土树树树树树無無無無無無树树树树树树树树树树树树树树树树树树
树树树树树树树树树树树树树树树树树树树土水水水水华水水土無無门学無無水水土土树树树树树無無门競無無树树树树树树树树树树树树树树树树树树
树树树树树树树树树树树树树树树树树树树土水华水水水水水土土土土土土土橋橋土土树树树树树树树土树树树树树树树树树树树树树树树树树树树树树
树树树树树树树树树树树树树树树树树树树土水水水水水水水土土土土土土土橋橋土土土树土土土土树土树树树树树树树树树树树树树树树树树树树树树
树树树树树树树树树树树树树树树树树树树土土土土土土土土土土土土土土土水水树树土树土树树土树土树树树树树树树树树树树树树树树树树树树树树
树树树树树树树树树树树树树树树树树树树土飾飾飾飾土土飾飾飾飾土土水水水水树树土土土树树土树土树树树树树树树树树树树树树树树树树树树树树
树树树树树树树树树树树树树树树树树树树土飾飾飾飾土土飾飾飾飾土土水水水水树树树树树树树土土土树树树树树树树树树树树树树树树树树树树树树
树树树树树树树树树树树树树树树树树树树土無無無無土土無無無無树树水水树树树树树树树树树树树树树树树树树树树树树树树树树树树树树树树树树
树树树树树树树树树树树树树树树树树树树土無门買無土土無门館無树树水水树树树树树树树树树树树树树树树树树树树树树树树树树树树树树树树树树
树树树树树树树树树树树树树树树树稂树树土土土土土土土土土土土土土橋橋土土树树树树树树树树树树树树树树树树树树树树树树树树树树树树树树树
树树树树树树树树树树树树树树树稂門稂树土土土土土土土土土土土土土橋橋土土树树树树树树树树树树树树树树树树树树树树树树树树树树树树树树树
树树树树树树树树树树树树树树树稂土稂树草草草草草草草草草草草水水水水土土树树树树树树树树树树树树树树树树树树树树树树树树树树树树树树树
树树树树树树树树树树树树树树树稂稂稂树草草草草草草草草草草草水水水水土土树稂稂稂稂稂稂稂树树树树树树树树树树树树树树树树树树树树树树树
树树树树树树树树树树树树树树树树树稂稂稂稂稂稂稂树稂稂稂稂树水水树树土土树稂稂稂無稂稂稂树树树树树树树树树树树树树树树树树树树树树树树
树树树树树树树树树树树树树树树树树树树稂稂树稂稂稂稂稂树稂稂水水树树土土树稂稂無無無稂稂树树树树树树树树树树树树树树树树树树树树树树树
树树树树树树树树树树树树树树树树树树树树稂稂稂树稂稂稂稂树稂水水树树土土稂稂無無门無無稂树树树树树树树树树树树树树树树树树树树树树树树
树树树树树树树树树树树树树树树树树树树树树稂稂稂稂树稂稂水水水水树树土土树稂稂稂稂稂稂稂树树树树树树树树树树树树树树树树树树树树树树树
树树树树树树树树树树树树树树树树树树树树稂稂树稂稂稂稂树水水水水树树土土树稂稂稂稂稂稂稂树树树树树树树树树树树树树树树树树树树树树树树
树树树树树树树树树树树树树树树树飾飾飾飾草草草草草草树草水水树树树树土土树树树树树树树树树树树树树树树树树树树树树树树树树树树树树树树
树树树树树树树树树树树树树树树树無门無無草草草草草草草草水水树树树树土土树树树树树树树树树树树树树树树树树树树树树树树树树树树树树树树
树树树树树树树树树树树树树树树树土土土土土土土土土土土土橋橋土土土土土土树树树树树树树树树树树树树树树树树树树树树树树树树树树树树树树
树树树树树树树树树树树树树树树树土土土土土土土土土土土土橋橋土土土土土土树树树树树树树树树树树树树树树树树树树树树树树树树树树树树树树
树树树树树树树树树树树树树树树树树树树树草草土土草草草草水水水水树树树树树树树树树树树树树树树树树树树树树树树树树树树树树树树树树树树
树树树树树树树树树树树树树树树树树树树树草草土土草草草草水水水水树树树树树树树树树树树树树树树树树树树树树树树树树树树树树树树树树树树
树树树树树树树树树树树树树树树树树树树树草草土土树树树树树树水水树树树树树树树树树树树社树树树树树树树树树树树树树树树树树树树树树树树
树树树树树树树树树树树树树树树树树树土土土土土土树树树树树树水水树树树树树树树树树树畑畑畑树树树树树树树树树树树树树树树树树树树树树树
树树树树树树树树树树树树树树树树树树土土土土土土树树树树树树水水树树树树畑畑畑畑畑畑畑畑畑树树树树树树树树树树树树树树树树树树树树树树
树树树树树树树树树树树树树树树树树树土土草草草草树树树树树树水水水水水树畑畑畑畑畑畑畑畑畑树树树树树树树树树树树树树树树树树树树树树树
树树树树树树树树树树树树树树树树树树土土草草草草树树树树树树水水水水水树畑畑畑畑畑畑畑畑畑树树树树树树树树树树树树树树树树树树树树树树
草土土土土花土树树树树树树树树树树树土土草草树树树树树树树树树树树水水树畑畑飾飾飾飾畑畑畑树树树树树树树树树树树树树树树树树树树树树树
土树土飾土土李树树树树树树树树树树树土土草草树树树树树树树树树树树水水树畑畑無门無無畑畑畑树树树树树树树树树树树树树树树树树树树树树树
土土飾飾飾土土树树树树树树树树树树树土土土土土土草草草草土土土土土橋橋土土土土土土土畑畑畑树树树树树树树树树树树树树树树树树树树树树树
土飾飾無飾飾土树树树树树树树树树树树土土土土土土草草草草土土土土土橋橋土土土土土土土畑畑畑树树树树树树树树树树树树树树树树树树树树树树
土飾無無無飾土树树树树树树树树树树树树树草草土土树树树树树树树树树水水树树树树树土土树树树树树树树树树树树树树树树树树树树树树树树树树
树無無门無無土树树树树树树树树树树树树树草草土土树树树树树树树树树水水水水树树树土土树树树树树树树树树树树树树树树树树树树树树树树树树
土道道道道道道树树树树树树树树树树树树树树树土土草草树树树树树树树水水水水草草草草草草草草草草草树树树树树树树树树树树树树树树树树树树
花道道道道道道树树树树树树树树树树树树树树树土土草草树树树树树树树树树水水草草草草草草草草草草草树树树树树树树树树树树树树树树树树树树
飾道道树树土土土土土土土草草草草草草草草树树树树草草树树树树树树树树树水水草草草树树草草草草草草树树树树树树树树树树树树树树树树树树树
飾道道树树土土土土土土土草草草草草草草草树树树树草草树树树树树树树树树水水草草草树树草草草草草草树树树树树树树树树树树树树树树树树树树
無道道树树树树树树树草草树树树树树树草草草草草草草草树树树树树树树树树水水水水草草草草草草草草草树树树树树树树树树树树树树树树树树树树
無道道树树树树树树树草草树树树树树树草草草草草草草草树树树树树树树树树水水水水草草草草草树树草草树树树树树树树树树树树树树树树树树树树
道道道树树树树树树树土土树树树树树树树树树树树树树树树树树树树树树树树树树水水草草草草草树树草草树树树树树树树树树树树树树树树树树树树
道道道树树树树树树树土土树树树树树树树树树树树树树树树树树树树树树树树树树水水草草草草草草草草草树树树树树树树树树树树树树树树树树树树
水水水树树树草草草草土土树畑畑畑果畑畑畑树树树树树树树树树树树树树树树树树水水草草草草草草草草草树树树树树树树树树树树树树树树树树树树
水水水树树树草草草草土土树畑畑畑畑畑畑畑树树树树树树树┏┲┳┱┓树树树树树水水草草草草草草草草草树树树树树树树树树树树树树树树树树树树
树树树树树树草草土土树树树畑畑畑社畑畑畑树树树树树树┏┳┣水┫┫树树树树树水水树树树树树土土树树树树树树树树树树树树树树树树树树树树树
树树树树草草草草土土树树树畑畑畑畑畑畑畑树树树树树树┣树┗滝┛┫树树树树树水水树树树树树土土树树树树树树树树树树树树树树树树树树树树树
树树树树草草草草草草草草树畑畑畑畑畑畑畑树树树树树树┣树水水树┫树树树树树水水树树树树树土土树树树树树树树树树树树树树树树树树树树树树
