無無無無無無無翼無無無無無無無
無無無無無無無翼無無無無無無無
無無無無無無無翼無無無無無無無
無無無無無翼翼翼翼翼無無無無無
無無無無無機機翼機機無無無無無
無無無無無翼翼翼翼翼無無無無無
無無無無無機機翼機機無無無無無
無無無無無翼翼翼翼翼無無無無無
無無無無無機機翼機機無無無無無
無無無無無翼翼翼翼翼無無無無無
無無無無無機機翼機機無無無無無
無無無無無翼翼翼翼翼無無無無無
無無無無無無無無無無無無無無無
無無無無無無無無無無無無無無無
無無無無無無無無無無無無無無無