無無無無無無無無無無無無無無無無無無無無無無無無無無無無無無無無無無無無無無無無無無無無
無無無無無無無無無無無無無無無無無無無無無無無無無無無無無無無無無無無無無無無無無無無無
無無無無無無無無無無無無無無無無無無無無無無無無無無無無無無無無無無無無無無無無無無無無
無無無無無無無無無無無無無無無無無無無無無無無無無無無無無無無無無無無無無無無無無無無無
無無無無無無無無無無無無無無無無無無無無無無無無無無無無無無無無無無無無無無無無無無無無
無無無無無無無無無無無無無無無無無無無無無無無無無無無無無無無無無無無無無無無無無無無無
無無無無無無無無無無無無無無無無無無無無無無無無無無無無無無無無無無無無無無無無無無無無
無無無無無無無無無無無無無無無無無無無無無無無無無無無無無無無無無無無無無無無無無無無無
無無無無無無無無無無無無無無無無無無無無無無無無無無無無無無無無無無無無無無無無無無無無
無無無無無無無無無無無無無無無無無無無無無無無無無無無無無無無無無無無無無無無無無無無無
無無無無無無無無無無無無無無無無無無無無無無無無無無無無無無無無無無無無無無無無無無無無
無無無無無無無無無無無無無無無無無無無無無無無無無無無無無無無無無無無無無無無無無無無無
無無無無無無無無無無石石石無無無無無無無無無無無無無無無無無無無無無無無無無無無無無無無
無無無無無無無無無無石石石石石石石無無無無無無無無無無無無無無無無無無無無無無無無無無無
無無無無無無無無無石石石石石石石石石石石石無無無無無無無無無無無無無無無無無無無無無無無
無無無無無無無無無石岩石石石石岩石石石石石石石石石石無無無無無無無無無無無無無無無無無無
無無無無無無無無無石石石石石石石石石石石石石石石石石無無無無無無無無無無無無無無無無無無
無無無無無無無無無石石石石石石石石石岩石石石石石石石石石無無無無無無無無無無無無無無無無
無無無無無無無無石石石石石岩石石石石石石岩石石石岩石石石無無無無無無無無無無無無無無無無
無無無無無無無無石石石岩石石石石石岩岩石岩石岩石石石石石無無無無無無無無無無無無無無無無
無無無無無無無無石石石石石石石岩石石穴穴穴穴穴穴穴石岩石無無無無無無無無無無無無無無無無
無無無無無無無無岩石石石石石岩石石岩穴穴穴穴穴穴穴石穴石無無無無無無無無無無無無無無無無
無無無無無無無無石石石岩石石石石岩石穴穴岩穴穴穴穴穴穴石無無岩石石無無無無無無無無無無無
無無無無無無無石石石石石石石岩石石石穴穴岩岩石穴穴穴石石無無石岩石無無無無無無無無無無無
無無無無無無無石石石石石石石石石石石穴穴石石石穴穴穴岩石無無石石石無無無無無無無無無無無
無無無無無無無石石岩石石岩石石岩石岩穴穴石岩石穴穴穴石石無無石石岩無無無無無無無無無無石
無無無無無無石岩石石石石石岩石石石石穴穴石石岩石穴石石石無無石岩石石石岩石無無無無無無石
無無無無無無石石石石石石穴穴穴穴穴穴穴穴穴穴石石入石石岩無無石石石岩石石岩無無無無無無石
無無無無無無石石石石岩石穴穴穴穴穴穴穴穴岩穴穴石無無石石無無無無無無石石石無無無無無無石
無無無無無無石石石石石石穴穴穴岩石石岩石岩岩穴石無無岩石無無無無無無石岩石岩石石石石石石
無無無無無石石石石岩石岩穴穴穴石穴穴穴石岩穴穴石無無石石石石岩石無無石石石石石岩石石石石
無無無無無石岩石石石石石穴穴穴石穴石石石穴穴石石無無石岩石岩石石無無石石石岩石石石岩石石
無無無無無石石岩石岩石石岩穴穴岩穴岩穴穴穴石岩石無無無無無無無無無無石岩石石石岩石石岩石
無無無無無無石石石石岩石岩穴穴石穴穴穴岩岩石石石無無無無無無無無無無石石無無無石石石石石
無無無無無無石石石石石石岩穴穴石石石穴穴岩石石岩石石無無無無無無無無無無無無無石岩石石石
無無無無無無石岩石石岩石穴穴穴石岩岩岩穴岩石石石石石無無無無無無無無無無無無無石石岩石石
無無無無無無無石石岩石石穴穴穴石岩穴穴穴岩石岩石穴石岩石石石石石石石岩石石石石石岩石石石
無無無無無無無石石石岩石穴穴穴石岩穴岩岩岩石石石穴穴穴石岩石石石穴石石石岩石岩石石石石無
無無無無無無無石石石石岩穴穴穴穴穴穴穴穴穴穴穴石岩岩穴石石石岩穴穴穴岩石石石石石石無無無
無無無無無無無無石石石石岩穴穴穴穴石穴石石石穴穴穴穴穴穴穴石岩穴岩穴岩穴石岩石石無無無無
無無無無無無無無石石岩石石石石石岩石入無石石石石穴石岩岩穴穴穴穴岩穴穴穴石石石無無無無無
無無無無無無無無無石石石石岩石石石石無無石岩石石石石石石石石石石岩穴石石石岩無無無無無無
無無無無無無無無無岩石岩石石石石無無無無無無無無無無無無無無岩石岩穴岩石無無無無無無無無
無無無無無無無無無石岩石石石岩石無無無無無無無無無無無無無無石石穴穴石石無無無無無無無無
無無無無無無無無無無岩石石石石石無無無無無無無無無無無無無無石岩穴石石岩無無無無無無無無
無無無無無無無無無無石石岩石石石無無無無無無無無無無無無無無岩穴穴岩石石無無無無無無無無
無無無無無無無無無無無無石石石岩無無無無無無無無無無無無無無石穴岩石岩石無無無無無無無無
無無無無無無無無無無無無石岩石石無無無無無無無無無無無無無無石穴岩石岩石無無無無無無無無
無無無無無無無無無無無無石石石石無無無無無無無無無無無無無無無入無石石石無無無無無無無無
草無無無無無無無無無無無石石石石無無無無無無無無無無無無無無無無無石石岩無無無無無無無無
無無無無無無無無無無無無岩石岩石無無無無無無無無無無無無無無無無無岩石石無無無無無無無無
無無無無無無無無無無無無石石石石無無無無無無無無無無無無無無石岩石石石石無無無無無無無無
無無無無無無無無無無無無石岩石石無無無無無無無無無無無無無無石石石岩石岩無無無無無無無無
無無無無無無無無無無無無石石石石石石石石石石石石石石石岩石石岩石石石石石無無無無無無無無
無無無無無無無無無無無無石石岩石石岩石岩石石石石石石石石岩石石石岩石岩岩無無無無無無無無
無無無無無無無無無無無無岩石石石石石石石岩石岩石石石岩岩石石岩石石石無無無無無無無無無無
無無無無無無無無無無無無岩石石石石石岩石石石石石石石石石石石岩石岩石無無無無無無無無無無
無無無無無無無無無無無無無無無無無無無無無無無無無無無無無無無無無無無無無無無無無無無無
無無無無無無無無無無無無無無無無無無無無無無無無無無無無無無無無無無無無無無無無無無無無
無無無無無無無無無無無無無無無無無無無無無無無無無無無無無無無無無無無無無無無無無無無無
無無無無無無無無無無無無無無無無無無無無無無無無無無無無無無石石無無無無無無無無無無無無
無無無無無無無無無無無無無無無無無無無無無無無無石石無飾飾飾飾树飾飾飾飾無無树树树树树树
無無無無無無無無無無無無無無無無無無無無無無無無石石土無门無無土飾飾飾飾無無树树树树树树