石石石┣穴穴┣穴┣穴穴穴穴穴穴穴穴穴穴穴穴岩┫穴┫畑畑畑畑畑畑畑树树树树树树水水水水水土土土土土土土土土树树树树树┳┳┳┳┳┳┳┳┳┳┳┳┳┳
石石石┣穴穴┣穴┣穴穴穴穴穴穴穴穴穴穴穴穴穴┫穴┫树树树树树树树树树树树树树水水水水水土土树土树土土树土树树树树树树树树树树树树树树树树树树树
石石石┣穴穴┣穴┣穴穴水水水水水水水水水水穴┫穴┫树树树树树树树树树树树树水水水水水土土土土土土土草草草树树树树树树树树草草草水水水水草草草草
石石石┣穴穴┣穴┣穴穴水水水水水水水水水水穴┫岩┫树树树树树树树树水水水水水水水水水土土土土土树草草草草树树树树树树树树树树草草草草水草草草草
石石石┣穴穴┣穴┣穴穴水水穴穴穴穴穴穴水水穴┫┌┛树树树树树树树树水水水水水水水水土土草草草草草草草草树树树树树树树树水水水水水草草水草草草草
石石石┣穴穴┣穴┣穴穴水水穴┌┻┻┻┻滝滝┻┛┫水水水水水水水水水水水树树树树草草草草草草草草草草草草树树树树树树树树水花草花水草草橋草树草草
石石石┣穴穴┣穴┣穴穴水水穴┫穴穴穴穴水水穴穴┫水水水水水水水水水水水树树树树草草草草草草草草土土土树树树树树树树树树水草土草水水水水草树树草
石石石┣穴穴┣穴┣穴穴水水穴┫穴┌┻┻滝滝┻┻┛水水树树树树树树树树树树树树树草草草草土土土土土土树树树树树树树树树树水花草草草草草草草树树草
石石石┣穴穴┣穴┣穴穴水水穴┫穴┫石石水水水水水水水树树树树树树树树树树树树树草草草土土土土土土土树树树树树树树树树树水水水草草草草草树树草草
石石石┣穴穴┣穴┣穴穴水水穴┫穴┫石石水水水水水水水树树┏┳┳┳┳┳┳┳┓树树树树土土土土土土土树树树树树树树树树草树树树水草草草草树树草草草
石石石┣穴穴┣穴┣穴穴水水穴┫穴┫石石石石石石石石石树树┣土土土草草草树┫树树树树树土土土土土树树树树树树树树树树草草草草水草草树树树草草草草
石石石┣穴穴┣穴┣穴穴水水穴┫穴┫石石石石石石石石石树树┣草草土土飾草树┫┌┻┻┻┻┻┻║║┻┻┻┻┻┻┻┻┻┻┐草草草草水草草树树树草草草草
石石石┣穴穴┣穴┣穴穴水水穴┫穴┫石石石石石石石石石树树┣草树草飾飾飾树┫┫土土土土土土土土土土土土土土土土土土┣树草草水水草树树┌┻┻┻┻┻
石石石┣穴穴┣穴┣穴穴水水穴┫穴┫石石石石石石石石石树树┣草树飾飾無飾飾┫┫土土土土土土土土土土土土土土土土土土┣树草草橋草草树树┫岩穴穴穴穴
石石石┣穴穴┣穴┣穴穴水水穴┫穴┫石石石石石石石石石树树┣草草飾無無無飾┫┫土土飾飾飾飾土土飾飾飾飾土土飾飾飾飾┣树树树水水树树树┫┌┻┻┻┻
石石石┣穴穴┣穴┣水水水水穴┫穴┫石石石石石石石石石树树┣树草無無门無無┫┳┓土飾飾飾飾土土飾飾飾飾土土飾飾飾飾┗┻┻┻┻滝┻┻┻┛┫岩穴穴穴
石石石┣穴穴┣穴┣水水水水穴┫穴┫石石石石石石石石石树树┣草草土土土土树┫土┫土無無無無土土無無無無土土無無無無水水水水水水水水水水┫┌┻┻┻
石石石┣穴穴┣穴┣水水穴穴穴┫穴┫石石石石石石石石石树树┣草土土花土土土─土┫土無门無無土土無门買無土土無门無無水水水水水水水水水水┫┫岩穴穴
石石石┣穴穴┣穴┣水水穴穴穴┫穴┫石石石石石石石石石树树┣草草土土花土土┫土─土土土土土土土土土土土土土土土土土水水穴穴穴穴穴岩水水┫┫穴穴穴
石石石┣穴穴┣穴┣穴穴穴穴穴┫穴┫石石石石石石石石石树树┗┻┐树花树土土┳┓┫土土土土土土土土土土土土土土土土土水水穴穴穴穴穴穴水水┫┫穴穴穴
石石石┣穴穴┣穴┗┻┻┻┻┻┛穴┫石石石石石穴穴穴穴穴穴穴穴┣土土土土土土┫┫土飾飾飾飾土土飾飾飾飾土土飾飾飾飾水水穴穴穴┌┻┻滝滝┛┫穴穴穴
石石石┣穴穴┣穴穴穴穴穴穴穴穴穴┫石石石石石穴穴穴穴穴穴穴穴┗┻┻┻┻┻┻┛┫土飾飾飾飾土土飾飾飾飾土土飾飾飾飾水水穴穴穴┫┌┻滝滝┻┛穴穴穴
石石石┣穴穴┗┻┻┻┻┻┻┻┻┻┛石石石石石穴穴穴穴水水水水水水水水水水水垣┫土無無無無土土無無無無土土無無無無水水穴穴穴┫┫水水水穴穴穴穴穴
石石石┣穴穴石石石石石石石石石石石石石石石石穴穴穴穴水水水水水水水水水水水垣┫土無门無無土土無门競無土土無门館無水水穴穴穴┫┫水水水穴穴穴穴穴
石石石┣石石石石石石石石石石石石石石石石石石穴穴穴穴水水飾飾飾飾道道道水水垣┫土土土土土土土土土土土土土土土土土橋橋穴穴穴──橋橋穴穴穴穴穴穴
石石石┣石石石石石石石石石石石石石石石石石石穴穴穴穴水水飾飾飾飾道垣垣水水垣┫土土土土土土土土土土土土土土土土土橋橋穴穴穴──橋橋穴穴穴穴穴穴
石石石┣石石石石石石石石石石石石石石石石石石穴穴穴穴水水無無無無道垣┌滝滝┻┛土土土土土土土土土土土土土土土土土水水┏┳┓┫┫水水水水水水水水
石石石┣石石石石石石石石石石石石石石石石石石穴穴穴穴水水無门無無道垣┫水水水水水水水水水圯圯水水水水水水水水水水水水┣穴┫┫┫水水水水水水水水
石石石┣石石石石石石石石石石石石石树树树树树穴穴穴穴水水道道道道道垣┫水水水水水水水水水圯圯水水水水水水水水水水水水┣穴┫┫┳┳┳┳┳┳┳┳┳
石石石石石石石石石石石石石石石石树树树树树树穴穴穴穴水水道道道道道垣┫穴穴穴穴穴穴穴穴穴道道穴穴穴穴穴穴穴穴穴穴穴穴┣穴┫┳┳┳┳┳┳┳┳┳┳
石石石石石石石石石石石石石石树树树树树树树土土土土土橋橋土穴穴穴穴垣┫穴穴穴穴穴穴穴穴穴道道穴穴穴穴穴穴穴穴穴穴穴穴┣穴┳┳┳┳┳┳┳┳┳┳┳
石石石石石石石石石石石石石树树树树树树土土土土土土土橋橋土穴穴┌┻┻┛穴穴穴穴穴穴穴穴穴道道穴穴穴穴穴穴穴穴穴穴穴穴┣穴穴穴穴穴穴穴穴穴穴穴穴
石石石石石石石石石石石石树树树树树土土土土土土土土土水水土土穴┫穴穴穴穴穴穴穴穴穴穴穴穴道道穴穴穴穴穴穴穴穴穴穴穴穴┗┻┻┻┻┻┻┻┻┻┻┻┻
石石石石石石石石石石石石树树树土土树土土土土水水水水水水土土穴┫穴穴穴穴穴穴穴穴穴穴穴穴道道穴穴穴穴穴穴穴穴穴穴穴穴穴石石石石石石石石石石石石
树树树树石石石石石石石树树树树土土土土土土水水水水水水水土土穴┫穴穴穴穴穴穴穴穴穴穴穴穴道道穴穴穴穴穴穴穴穴穴穴穴穴穴石石石石石石石石石石石石
树树树树树树树树树树树树树树土土土土土土土水水水水水水水土土穴┫穴穴穴穴穴穴穴穴穴穴穴穴道道穴穴穴穴穴穴穴穴穴穴穴穴穴穴石石石石石石石石石石石
树树树树树树树树树树树树树土土土树土土土水水水水水水水水土土穴┫穴穴穴穴穴穴穴穴穴穴穴穴道道穴穴穴穴穴穴穴穴穴穴穴穴穴穴石石石石石石石石石石石
树树树树树树树树树树树树树树土土土土土土水水水水水水水水土土道─道道道道道道道道道道道道道道穴穴穴穴穴穴穴穴穴穴穴穴穴穴穴石石石石石石石石石石
树树树树树树树树树树树树土土土土土土土土水水水水水水水土土土道─道道道道道道道道道道道道道道穴穴穴穴穴穴穴穴穴穴穴穴穴穴穴穴石石石石石石石石石
树树树树树树树树树树树树土土土土土土土土水水水水水水水土土土树┫穴穴穴穴穴穴穴穴穴穴穴穴穴穴穴穴穴穴穴穴穴穴穴穴穴穴穴穴穴穴石石石石石石石石石
树树树树树树树树树树树土树土土土土土土水水水水水水土土土土树树┫穴穴穴穴穴穴穴穴穴穴穴穴穴穴穴穴穴穴穴穴穴穴穴穴穴穴穴穴穴穴穴石石石石石石石石
树树树树树树树树树树树土土土土土土土水水水土土土土土土树土土树┫穴穴穴穴穴穴穴穴穴穴穴穴穴穴穴穴穴穴穴穴穴穴穴穴穴穴穴穴穴穴穴穴石石石石石石石
树树树树树树树树树树树土土土土水水水水水水土土树土土土土土土树┫穴穴穴穴穴穴穴穴穴穴穴穴穴穴穴穴穴穴穴穴穴穴穴穴穴穴穴穴穴穴穴穴石石石石石石石
树树树树树树树树树树土土土土水水水水水水水土土土土土土土土土树┳┳┳┳┳┳┳┳┳┳┳┳┳┳┳┳┳┳┳┳┳┳┳┳┳┳┳┳┳┳┳┳┳┳石石石石石石
土土土土土土土土土土土土土水水水水水水水土土土土土土土树土树树树石石石石石石石石石石石石石石石石石石石石石石石石石石石石石石石石石石石石石石石
土土土土土土土土土土土土土水水水水水水水土土土土土树土土土树树石石石石石石石石石石石石石石石石石石石石石石石石石石石石石石石石石石石石石石石石
树树树树┏┳┳┳┳┓土土土水水水水水水水土土土土土土树土土树石石石石石石石石石石石石石石石石石石石石石石石石石石石石石石石石石石石石石石石石石
树树树树┣穴穴穴穴┫土土土水水水水水水水土土土土土树土土树树石石石石石石石石石石石石石石石石石石石石石石石石石石石石石石石石石石石石石石石石石
树树树树┣穴水水穴┫土土土水水水水水水土土土土树土土树树树石石石石石石石石石石石石石石石石石石石石石石石石石石石石石石石石石石石石石石石石石石
树树树树┣穴水水穴┫土土土土水水水水水树土土土土土土树树石石石石石石石石石石石石石石石石石石石石石石石石石石石石石石石石石石石石石石石石石石石
树树树树┣穴水水穴┫土土土土水水水土土土土树土土土树树石石石石石石石石石石石石石石石石石石石石石石石石石石石石石石石石石石石石石石石石石石石石
树树树树┗┻滝滝┻┛土土土土水水水土土土土土土土树树树石石石石石石石石石石石石石石石石石石石石石石石石石石石石石石石石石石石石石石石石石石石石
树树树树树树水水土土土土土水水水土土土土土土土树树树石石石石石石石石石石石石石石石石石石石石石石石石石石石石石石石石石石石石石石石石石石石石石
树树树树树树水水水水水水水水水水土土土树树土树树树石石石石石石石石石石石石石石石石石石石石石石石石石石石石石石石石石石石石石石石石石石石石石石
树树树树树树水水水水水水水水水水树树树树树树树树石石石石石石石石石石石石石石石石石石石石石石石石石石石石石石石石石石石石石石石石石石石石石石石
树树树树树树树树树树树树树树树树树树树树树树树树石石石石石石石石石石石石石石石石石石石石石石石石石石石石石石石石石石石石石石石石石石石石石石石
树树树树树树树树树树树树树树树树树树树树树树树石石石石石石石石石石石石石石石石石石石石石石石石石石石石石石石石石石石石石石石石石石石石石石石石
树树树树树树树树树树树树树树树树树树树树树树石石石石石石石石石石石石石石石石石石石石石石石石石石石石石石石石石石石石石石石石石石石石石石石石石
树树树树树树树树树树树树树树树树树树树石石石石石石石石石石石石石石石石石石石石石石石石石石石石石石石石石石石石石石石石石石石石石石石石石石石石
石石石树树树树树树树树树树树石石石石石石石石石石石石石石石石石石石石石石石石石石石石石石石石石石石石石石石石石石石石石石石石石石石石石石石石石
石石石石石树树树树树石石石石石石石石石石石石石石石石石石石石石石石石石石石石石石石石石石石石石石石石石石石石石石石石石石石石石石石石石石石石石
石石石石石石石石石石石石石石石石石石石石石石石石石石石石石石石石石石石石石石石石石石石石石石石石石石石石石石石石石石石石石石石石石石石石石石石
石石石石石石石石石石石石石石石石石石石石石石石石石石石石石石石石石石石石石石石石石石石石石石石石石石石石石石石石石石石石石石石石石石石石石石石
石石石石石石石石石石石石石石石石石石石石石石石石石石石石石石石石石石石石石石石石石石石石石石石石石石石石石石石石石石石石石石石石石石石石石石石
