树树树树树树树树树树树树树树树树树树树树树树树树树树土土土水水树树树树树树树树树树树树树树树
树树树树树树树树树树树树树树树树树树树树树树树树树树土土土水水树树树树树树树树树树树树树树树
树树树树树树树树树树树树树树树树树树树树树树树树树树土土土水水树树树树树树树树树树树树树树树
树树树树树树树树树树树树树树树树树树树树树树树树树树土土土水水树树树树树树树树树树树树树树树
树树树树树树树树树树树树树树树树树树树树树树树树树树土土土水水树树树树树树树树树树树树树树树
树树树树树树树树树树树树树树树树树树树树树树树树树树土土土水水树树树树树树树树树树树树树树树
树树树树树树树树树树树树树树树树树树树水水水水水水水圯水水水水树树树树树树树树树树树树树树树
树树树树树树树树树树树树树树树树树树树水水水水水水水圯水水水水树树树树树树树树树树树树树树树
树树树树树树树树树树树树树树土土土土土水水道道道道道道树树树树树树树树树树树树树树树树树树树
树树树树树树树树树树树飾飾飾飾飾飾道道橋橋道道道道道道树树树树树树树树树树树树树树树树树树树
树树树树树树树树树树树飾飾飾飾飾飾道道水水飾飾飾飾道道树树树树树树树树树树树树树树树树树树树
树树树树树树树树树树树無無無無無無道道水水飾飾飾飾道道土花李树树树树树树树树树树树树树树树树
树树树树树树树树树树土無無门競無無道道水水無無無無道道土李花树树树树树树树树树树树树树树树树
树树树树树树树树树土土道道道道道道道道水水無门買無道道土花李树树树树树树树树树树树树树树树树
树树树树树树树树土土土道道道道道道道道橋橋道道道道道道土李花树树树树树树树树树树树树树树树树
水水水水水水水水水水水圯水水水水水圯水水水道道道道道道土花李树树树树树树树树树树树树树树树树
水水水水水水水水水水水圯水水水水水圯水水水飾飾飾飾道道飾飾飾飾树树树树树树树树树树树树树树树
飾飾飾飾土土土土土道道道道道道道道道道水水無门無無道道飾飾飾飾树树树树树树树树树树树树树树树
無门無無土土土土土道道道道道道道道道道橋橋道道道道道道無無無無树树树树树树树树树树树树树树树
土土土土土土树树树道道飾飾飾飾飾飾道道水水道道道道道道無门館無树树树树树树树树树树树树树树树
土土土土土土树树树道道飾飾飾飾飾飾道道水水飾飾飾飾道道道道道道土土土土土土土树树树树树树树树
树树树树树树树树树道道無無無無無無道道水水無门無無道道道道道道土土土土土土土树树树树树树树树
树树树树树树树树树道道無無门学無無道道水水道道道道道道树树树树树树树树树土土树树树树树树树树
树树树树树树树树树道道道道道道道道道道橋橋道道道道道道树树树树树树树树树土土树树树树树树树树
树树树树树树树树树道道道道道道道道道道水水树树树树树树树树树树树树树树树土土树树树树树树树树
树树树树树树树树树树树道道树树树树树树水水树树树树树树树树树树树树树树树土土树树树树树树树树
树树树树树树树树树树树道道树树树树树树水水树树树树树树树树树树树树树树树土土树树树树树树树树
树树树树树树树树树树树道道树树树树树树水水树树树树树树树树树树树树树树树土土树树树树树树树树
树树树树树树树树树树树道道树树树树树树水水树树树树树树树树树树树树树树树土土树树树树树树树树
树树树树树树树树树树树道道树树树树树树水水树树树树树树树树树树树树树树树土土树树树树树树树树
树树树树树树树树树树树道道树树树树树树水水树树树树树树树树树树树树树树树土土树树树树树树树树
树树树树树树树树树树树道道树树树树树树水水树树树树树树树树树树树树树树树土土树畑畑畑畑畑畑畑
树树树树树树树树树树树道道树树树树树树水水树树树树树树树树树树树树树树树土土树畑畑畑畑畑畑畑
树树树树树树树树树树树道道树树树树树树水水树树树树树树树树树树树树树树树土土树畑畑畑畑畑畑畑
树树树树树树树树树树树道道树树树树树树水水树树树树树树树树树树树树树树树土土树畑畑畑畑畑畑畑
树树树树树树树树树树树道道树树树树树树水水树树树树树树树树树树树树树树树土土树畑畑畑畑畑畑畑
树树树树树树树树树树树道道树树树树树树水水树树树树树树树树树树树树树树树土土树畑畑畑畑畑畑畑
