道道道道橋橋橋道道道道道道道道道道道道道道道道道道树土無無無门学無無無土道道道道道道水水水水水水水水水水水
道道道道橋橋橋道道道道道道道道道道道道道道道道道道树土土土土道道土土土土道道树树道道水水水水水水水水水水水
┳┓树树水水水树树树土土土土土土土土土土土土土道道树土水水土道道道道道道道道树树道道水水水树树树树树树树树
树┫树树水水水树树树土土土土土土土土土土土土土道道树土水水土道道道道道道道道树树道道水水水树树树树树树树树
树┫树树水水水树树树土土土土土土土土树土土土土道道树土水水土土土土土土土土土树树道道水水水树草土草土草土草
树┫树树水水水树树树树树树树树土土土土土土土土道道树土土土土土土土土土土土土树树道道水水水树土树土树土树土
树┫树树水水水树树树树树树树树树树树树树树树树道道树树树树树树树树树树树树树树树道道水水水草土草土草土草土
树┳┓树水水水树树树树树树树树树树树树树树树树道道树树树树树树树树树树树树树树树道道水水水土树土树土树土树
畑树┫树水水水树树树树树树树树树树树树树树树土道道土土土草草草草树树树树树树树树道道橋橋橋土土土草土草土草
畑树┫树水水水树树树树树树树树树树树树树树树土土土土土土草草草草树树树树树树树树道道橋橋橋土土土土树土树土
畑树┫树水水水树树树树树树树树树树树树树树树土土土土土土草草草草水水水水水水水水水水水水水土土土土草土草土
畑树┫树水水水树树树树树树树树树石石树树树树土土土土土土草草草草水水水水水水水水水水水水水土土土土土树土树
畑树┫树水水水树树树树树树树树树石石树树树树土土土土土土草草草草水水水水水水水水水水水水水土土土土土土土草
畑树┫树水水水树树树树树树树树树石石石石草草土土土土土土草草草草水水水树树树树树树树稂稂土土土土土土土土土
畑树┳┓水水水水树树树树树树树树石石石石草草土土土土土土草草草草水水水树树树树树树树稂稂土土土土土土土土树
树树树┫水水水水树树树树树树树树树树树树草草草草土土草草草草石石水水水树树树树树树树稂稂土土草草草草草草草
树树树┫水水水水树树树树树飾飾飾飾树树树草草草草土土草草草草石石水水水树树树树树树树稂稂土土草草草草草草草
树树树┫水水水水树树树树树無门無無树树树树树草草土土树树石石石石水水水树树树树树树树土土土土草草草草草草草
树树树┫水水水水树树树树树土土土土树树树树树草草土土树树石石石石水水水树树树树树树树土土土土草草草草草草草
树树树┫水水水水树树树树树树土土树树树树树树草草草草水水水水水水水水水树树树树树树树土土稂稂稂稂稂稂稂稂稂
树树树┫水水水水草草草草草草土土树树草草草草草草草草水水水水水水水水水树树树树树树树土土稂稂稂稂稂稂稂稂稂
树树树┫水水水水草草草草草草土土树树草草草草草草草草水水水水水水水水水树树树树树树树土土土土土土土土土土土
树树树┫水水水水土土树树树树树树树树土土道道土土草草水水水树树树树树树树树树树树树树土土土土土土土土土土土
树树树┫水水水水土土树树树树树树树树土土道道土土草草水水水树树树树树树树树树树树树树树树树畑畑畑畑畑畑畑畑
树树树┫水水水水土土土土土土飾飾飾飾道道道道土土树树水水水树树树树树树树树树树树树树树树树畑畑畑畑畑畑畑畑
树树树┫水水水水土土土土土土無门無無道道道道土土树树水水水树树树树树树树树树树树树树草草草畑畑畑飾飾飾飾畑
道道道─橋橋橋橋道道道道道道道道道道道道道道飾飾飾飾水水水树树树树树树树树树树树树树草草草畑畑畑無门無無畑
道道道─橋橋橋橋道道道道道道道道道道道道道道無门無無水水水树树树树树树树树树树树树树草草草畑畑畑畑土土畑畑
树树树┫水水水水土土土土土土飾飾飾飾道道道道道道道道水水水树树树树树树树树树树树树树草草草畑畑畑畑土土畑畑
树树树┫水水水水土土土土土土飾飾飾飾道道道道道道道道水水水树树树树树树树树树树树树树树树树树树土土土土土土
树树树┫水水水水水水水水水水無無無無道道道道土土树树水水水树树树树树树树树树树树树树树树树树树土土土土土土
树树树┫水水水水水水水水水水無门無無道道道道土土树树水水水树树树树树树树树树树树树树树树稂稂稂土土草草草草
树树树┫水水水水水水水水水水道道道道道道道道土土树树水水水树树树树树树树树树树树树树树树稂稂稂土土草草草草
树树树┫水水水水水水水水水水道道道道道道道道土土树树水水水树树树树树树树树树树树树树树树稂稂稂土土草草草草
树树树树树树树树树树水水水水水水水水水水圯圯水水水水水水水树树树树树树树树树树树树树树树稂稂稂土土土土土土
树树树树树树树树树树水水水水水水水水水水圯圯水水水水水水水树树树树树树树树树树树树树树树稂稂稂土土土土土土
树树树树树树树树树树水水水水水水水水水水圯圯水水水水水水水树树树树树树树树树树树树树树树稂稂稂稂稂稂草草土
树树树树树树树树树树水水水水水水水水水水圯圯水水水水水水水树树树树树树树树树树树树树树树稂稂稂稂稂稂草草土
树树树树树树树树树树树树水水草草草草草草土土稂稂水水水水水树树树树树树树树树树树树树树树树树树树稂稂草草土
树树树树树树树树树树树树水水草草草草草草土土稂稂水水水水水树树树树树树树树树树树树树树树树树树树稂稂稂稂草
树树树树树树树树树树树树水水草草稂稂草草草草草草水水水水水树树树树树树树树树树树树树树树树树树树稂稂稂稂草
树树树树树树树树树树树树水水草草稂稂草草草草草草水水水水水树树树树树树树树树树树树树树树树树树树树树稂稂草
树树树树树树树树树树树树水水稂稂稂稂草草土土草草水水水水水树树树树树树树树树树树树树树树树树树树树树稂稂草
树树树树树树树树树树树树水水稂稂稂稂草草土土草草水水水水水树树树树树树树树树树树树树树树树树树树树树稂稂草
树树树树树树树树树树树树水水草草树树草草草草稂稂水水水水水树树树树树树树树树树树树树树树树树树树树树树树土
树树树树树树树树树树树树水水草草树树草草草草稂稂水水水水水树树树树树树树树树树树树树树树树树树树树树树树土
树树树树树树树树树树树树水水土土树树稂稂草草稂稂水水水水水树树树树树树树树树树树树树树树树树树树树树树树稂
树树树树树树树树树树水水水水土土树树稂稂草草稂稂水水水水水树树树树树树树树树树树树树树树树树树树树树树树稂
树树树树树树树树树树水水水水土土树树稂稂草草草草稂稂水水水树树树树树树树树树树树树树树树树树树树树树树树树
树树树树树树树树树树水水树树土土树树稂稂草草草草稂稂水水水树树树树树树树树树树树树树树树树树树树树树树树树
树树树树树树树树树树水水树树草草树树稂稂稂稂草草稂稂水水水树树树树树树树树树树树树树树树树树树树树树树树树
树树树树树树树树树树水水树树草草树树稂稂稂稂草草稂稂水水水树树树树树树树树树树树树树树树树树树树树树树树树
树树树树树树树树水水水水树树土土稂稂草草稂稂稂稂稂稂水水水树树树树树树树树树树树树树树树树树树树树树树树树
树树树树树树树树水水水水树树土土稂稂草草稂稂稂稂稂稂水水水树树树树树树树树树树树树树树树树树树树树树树树树
树树树树树树树树水水树树树树树树草草土土稂稂草草稂稂水水水树树树树树树树树树树树树树树树树树树树树树树树树
树树树树树树树树水水树树树树树树草草土土稂稂草草稂稂水水水树树树树树树树树树树树树树树树树树树树树树树树树
树树树树树树树树水水树树树树树树树树土土稂稂草草草草水水水树树树树树树树树树树树树树树树树树树树树树树树树
树树树树树树树树水水树树树树树树树树土土稂稂草草草草水水水树树树树树树树树树树树树树树树树树树树树树树树树
树树树树树水水水水水树树树树树树树树树树草草草草草草水水水树树树树树树树树树树树树树树树树树树树树树树树树
树树树树树水水水水水树树树树树树树树树树草草草草草草水水水水水树树树树树树树树树树树树树树树树树树树树树树
树树树树树水水树树树树树树树树树树树树树草草土土草草水水水水水树树树树树树树树树树树树树树树树树树树树树树
树树树树树水水树树树树树树树树树树树树树草草土土草草水水水水水树树树树树树树树树树树树树树树树树树树树树树
树树树树树水水树树树树树树树树树树土土土土土土土飾飾飾飾水水水树树树树树树树树树树树树树树树树树树树树树树
树树树树树水水树树树树树树树树树树土土土土土土土無门無無水水水树树树树树树树树树树树树树树树树树树树树树树
树树树树树水水树树树树树树树树树树飾飾飾飾土土土土土土土水水水树树树树树树树树树树树树树树树树树树树树树树
树树树树树水水树树树树树树树树树树無门無無土土土土土土土水水水树树树树树树树树树树树树树树树树树树树树树树
树树树树树水水树树树树树树树树树树土土土土土土土土土水水水水水水水水水水水水水水水水水水水水水水水水水水水
树树树树树水水树树树树树树树树树树土土土土土土土土土水水水水水水水水水水水水水水水水水水水水水水水水水水水
树树树树树水水树树树树树树树树土土土土土土土土土树树水水水水水草树树树树树树树树树树树树树树树树树树树树水
树树树树树水水树树树树树树树树土土土土土土土土土树树水水水草草草树树树树树树树树树树树树树树树树树树树树水
树树树树树水水树树树树树树树树草草草草草草草土土树树水水水草草草草草树树树树树树树树树树道道道道道道道道橋
树树树树树水水树树树树树树树树草草草草草草草土土树树水水水草草草草草树树树树树树树树树树道道道道道道道道橋
树树树树树水水树树树树树树树树树树树树树树树土土树树水水水草草草草草草草树树树树树树树树道道树树树树树树水
树树树树树水水树树树树树树树树树树树树树树树土土树树水水水草草草草草草草树树树树树树树树道道树树树树树树水
树树树树树水水树树树树树树树树树树树树树树树土土树树水水水土土土土土土土树树树树树树树树道道树树树树树树水
树树树树树水水树树树树树树树树树树树树树树树土土树树水水水土土土土土土土树树树树树树树树道道树树树树树树水
树树树树树水水树树树树树树树树树树树树树树树土土土土橋橋橋道道道道道道道道道道道道道道道道道树树树树树树树
树树树树树水水树树树树树树树树树树树树树树树土土土土橋橋橋道道道道道道道道道道道道道道道道道树树树树树树树
