树树树树树树树树树树树树树树树树土土树树树树树树树树树树树树树树树树树树树树树树树树树树树树树树树树树树┣┗滝滝┻┐水水┣┗┻┻┛┫水水穴穴穴穴穴
树树树树树树树树树树树树树树树树土土土土土树树树树树树树树树树树树树树树树树树树树树树树树树树树树树树树┗┻滝滝┐┣水水┗┻┻┻┻┛水水穴穴穴穴穴
树树树树树树树树树树树树树树树树土土土土土树树树树树树树树树树树树树树水水水水水水水水水水水水水水水水水水水水水┣┣水水水水水水水水水水穴穴穴┏┳
树树树树树树树树树树树树树树树树树树树土土树树树树树树树树树树树树树树水水水水水水水水水水水水水水水水水水水水水┣┣水水水水水水水水水水穴穴穴┣┏
树树树树树树树树树树树树树树树树树树树土土树树树树树树树树树树树树树树水水树树树树树树树树树树树树树树树树树树树┣┣穴穴穴┏┳┳┓穴穴穴穴穴穴┣┣
树树树树树树树树树树树树树树树树树树树土土树树畑畑畑畑畑畑畑畑畑树树树水水树树树树树树树树树树树树树树树树树树树┣┣穴穴穴┣穴穴┫穴穴穴穴穴穴┣┣
树树树树树树树树树树树树树树树树树树树土土树树畑树畑畑畑树畑畑畑树树树水水树树树树树树树树树树树树树树树树树树树┣┗┻║┐┣穴穴┫穴穴穴穴穴穴┣┗
树树树树树树树树树树树树树土土土土土土道道树树畑畑畑树畑畑畑树畑水水水水水树树树树树树树树树树树树树树树树树石石┣岩穴穴┣┗┻┻┛穴穴穴穴穴穴┗┻
树树树树树树树树树树树树树土土土土土土道道树树畑畑畑畑畑畑畑畑畑水水水水水树树树树树树树树树树树树树树树树树石石┣穴穴穴┗┻┻┻┻┐┣穴穴┏┳┳┳
树树树树树树树树树树树树树土土土树土土道道水水水水水水水水水圯圯水水石石石石石树树树树树石石石穴穴穴土土土土石石┗┻║┻┻┻┻入┐┣┣穴穴┗┻┻┻
树树树树树树树树树树树树树土土土土土土道道水水水水水水水水水圯圯水水石石石石石树树树树树石石石穴岩穴土土土土穴穴穴穴穴岩石穴穴穴┣┣┣穴穴穴穴┌入
树树树树树树树树树树树树树土土土土土土道道水水土土土飾飾飾飾土土树树石石石石石树树树树树石石石穴穴石石石土土土穴穴穴穴穴石穴岩岩┣┣┣穴穴┌┻┛穴
水水水水水水水水水水水水水土土飾飾飾飾道道水水土土土無门無無土土树树石石石土土土土穴穴穴穴土土土土石石石树树树石石穴穴穴石穴穴穴┣┣┣穴┌┛穴穴穴
水水水水水水水水水水水水水土土飾飾飾飾道道水水飾飾飾飾土土土土土树树石石石土土土土穴穴穴穴土土土土石石石树树树石石穴穴穴石岩穴穴┣┣┣┌┛穴穴穴穴
树树树树树树树树树树树水水土土無無無無道道水水無门無無土土土土土树树树树树土土石石石树树树树树石石树树树树树树树树树穴穴穴穴穴穴┣┣┣┫穴穴┏┳┓
树树树树树树树树树树树水水土土無门館無道道水水道道道道道道道道道土土土穴穴穴穴石石石树树树树树石石树树树树树树树树树岩穴穴穴岩穴┣┣┣┳u┳┳穴┳
树树树道道道道道道道道橋橋道道道道道道道道橋橋道道道道道道道道道土土土穴穴穴穴石石石树树树树树树树树树树树树树树树树树树┏┲┳┳┳┣┣穴穴穴穴穴穴
树树树道道道道道道道道橋橋道道道道道道道道橋橋道道土土土土树土土树树树树树树树树树树树树树树树树树树树树树树树树树树树┏┲┳穴穴穴┣┣┏┳┳┳┓穴
树树树道道树树树树树树水水土土土土土土土土水水道道土树土土土土土树树树树树树树树树树树树树树树树树树树树树树树树树树┏┲┳穴穴穴穴┣┣┣穴穴穴┫穴
树树树道道树树树树树树水水土土土土土土土土水水道道土土土土土土树树树树树树树树树树树树树树树树树树树树树树树树树树┏┲┳穴穴穴穴┏┳┳┣穴穴穴┫┌
树树树道道树树树树树树水水水水水水水水水水水水土土树树树树树树树树树树树树树树树树树树树树树树树树树树树树树树树树┣┣穴穴穴穴穴┣┏┳┳穴穴穴┫┫
树树树道道树树树树树树水水水水水水水水水水水水土土树树树树树树树树树树树树树树树树树树树树树树树树树树树树树树树树┣┣穴穴穴┏┳┳┣穴穴穴┌┻┛┫
道道道道道树树树树树树树树树树树树树树树树树树土土树树树树树树树树树树树树树树树树树树树树树树树树树树树树树树树树┣┣穴┏┳┳┏┳┳穴穴┌┛┌入┛
道道道道道树树树树树树树树树树树树树树树树树树土土树树树树树树树树树树树树树树树树树树树树树树树树树树树树树树树树┣┣穴┣┏┳┳穴穴┌┻┛┌┛穴┌
树树树树树树树树树树树树树树树树树树树树树树树土草树树树树树树树树树树树树树树稂树草树树树树树树树树树树树树树┏┲┳┳穴┣┣穴穴穴┌┛┌┻┛穴穴┫
树树树树树树树树树树树树树树树树树树树树树树树草土树树树树树树树稂稂树草草稂稂稂草树树树树树树树树树树树树树┏┲┳穴穴穴┣┗┻┻┻┛┌┛穴穴穴┌┛
树树树树树树树树树树树树树树树树树树树树树草稂草草草稂草草稂稂树稂稂稂稂稂稂树草树树树树树树树树树树树树树树┣┣穴穴穴穴┗┻┻┻┛┌┛穴穴┌║┛土
树树树树树树树树树树树树树树树树树树树树树草草土树草草草稂稂树草草树草稂稂稂稂稂树树树树树树树树树树树树树┏┲┳穴穴┌┻┻┻┻┻入┛穴穴┌┛土土土
树树树树树树树树树树树树树树树树树树树树草草树草草草草稂稂草草草草稂稂树树稂稂稂稂稂树树树树树树树树树树树┣┣穴穴穴┫┌┻┻┻┐穴穴穴┌┛李土树土
