道道道树树道道水水水树树树树树树树树树树树树树树树树树树树树树树水树
道道道树树道道水水水树树树树树树树树树树树树树树树树树树树树树树水水
土土土树树道道水水水树草土草土草土草树树树树树树树树树树树树树树树树
土土土树树道道水水水树土树土树土树土树树树树树树树树树树树树树树树树
树树树树树道道水水水草土草土草土草土草树树树树树树树树树树树树树树树
树树树树树道道水水水土树土树土树土树土树树树树树树树树树树树树树树树
树树树树树道道橋橋橋土土土草土草土草土草树树树树树树树树树树树树树树
树树树树树道道橋橋橋土土土土树土树土树土树树树树树树树树树树树树树树
水水水水水水水水水水土土土土草土草土草土树树树树树树树树树树树树树树
水水水水水水水水水水土土土土土树土树土树树树树树树树树树树树树树树树
水水水水水水水水水水土土土土土土土草土树树树树树树树树树树树树树树树
树树树树树树树稂稂土土土土土土土土土树树树树树树树树树树树树树树树树
树树树树树树树稂稂土土土土土土土土树树树树树树树树树树树树树树树树树
树树树树树树树稂稂土土草草草草草草草树树树树树树树树树树树树树树树树
树树树树树树树稂稂土土草草草草草草草树树树树树树树树树树树树树树树树
树树树树树树树土土土土草草草草草草草树树树树树树树树树树树树树树树树
树树树树树树树土土土土草草草草草草草树树树树树树树树树树树树树树树树
树树树树树树树土土稂稂稂稂稂稂稂稂稂树树树树树树树树树树树树树树树树
树树树树树树树土土稂稂稂稂稂稂稂稂稂树树树树树树树树树树树树树树树树
树树树树树树树土土土土土土土土土土土土土土土稂稂树树树树树树树树树树
树树树树树树树土土土土土土土土土土土土土土土稂稂树树树树树树树树树树
树树树树树树树树树树畑畑畑畑畑畑畑畑畑畑土土稂稂树树树树树树树树树树
树树树树树树树树树树畑畑畑畑畑畑畑畑畑畑土土稂稂树树树树树树树树树树
树树树树树树树草草草畑畑畑飾飾飾飾畑畑畑土土稂稂树树树树树树树树树树
树树树树树树树草草草畑畑畑無门無無畑畑畑土土稂稂树树树树树树树树树树
树树树树树树树草草草畑畑畑畑土土畑畑畑畑土土稂稂稂稂树树树树树树树树
树树树树树树树草草草畑畑畑畑土土畑畑畑畑土土稂稂稂稂树树树树树树树树
树树树树树树树树树树树树土土土土土土土土土土稂稂稂稂树树树树树树树树
树树树树树树树树树树树树土土土土土土土土土土稂稂稂稂树树树树树树树树
树树树树树树树树树稂稂稂土土草草草草草草草树树树树树树树树树树树树树
树树树树树树树树树稂稂稂土土草草草草草草草树树树树树树树树树树树树树
树树树树树树树树树稂稂稂土土草草草草草草草树树树树树树树树树树树树树
树树树树树树树树树稂稂稂土土土土土土土草草树树树树树树树树树树树树树
树树树树树树树树树稂稂稂土土土土土土土草草稂稂稂稂稂树树树树树树树树
树树树树树树树树树稂稂稂稂稂稂草草土土草草稂稂稂稂稂树树树树树树树树
树树树树树树树树树稂稂稂稂稂稂草草土土土土稂稂稂稂稂树树树树树树树树
树树树树树树树树树树树树树稂稂草草土土土土稂稂稂稂稂树树树树树树树树
树树树树树树树树树树树树树稂稂稂稂草草土土稂稂稂稂稂树树树树树树树树
树树树树树树树树树树树树树稂稂稂稂草草土土稂稂稂稂稂树树树树树树树树
树树树树树树树树树树树树树树树稂稂草草土土稂稂稂稂稂树树树树树树树树
树树树树树树树树树树树树树树树稂稂草草草草草草草稂稂树树树树树树树树
树树树树树树树树树树树树树树树稂稂草草草草草草草稂稂树树树树树树树树
树树树树树树树树树树树树树树树树树土土土土土草草树树树树树树树树树树
树树树树树树树树树树树树树树树树树土土土土土草草树树树树树树树树树树
树树树树树树树树树树树树树树树树树稂稂稂稂稂土土树树树树树树树树树树
树树树树树树树树树树树树树树树树树稂稂稂稂稂土土树树树树树树树树树树
树树树树树树树树树树树树树树树树树树树树稂稂土土树树树树树树树树树树
树树树树树树树树树树树树树树树树树树树树稂稂土土树树树树树树树树树树
树树树树树树树树树树树树树树树树树树树树稂稂土土树树树树树树树树树树
树树树树树树树树树树树树树树树树树树树树稂稂土土树树树树树树树树树树
树树树树树树树树树树树树树树树树树树树树稂稂土土树树树树树树树树树树
树树树树树树树树树树树树树树树树树树树树树树土土树树树树树树树树树树
树树树树树树树树树树树树树树树树树树树树树树土土树树树树树树树树树树
树树树树树树树树树树树树树树树树树树树树树树土土土土土树树树树树树树
树树树树树树树树树树树树树树树树树树树树树树土土土土土树树树树树树树
树树树树树树树树树树树树树树树树树树树树树树树树树土土树树树树树树树
树树树树树树树树树树树树树树树树树树树树树树树树树土土树树树树树树树
树树树树树树树树树树树树树树树树树树树树树树树树树土土树树畑畑畑畑畑
树树树树树树树树树树树树树树树树树树树树树树树树树土土树树畑树畑畑畑
树树树树树树树树树树树树树树树树树树树土土土土土土道道树树畑畑畑树畑
树树树树树树树树树树树树树树树树树树树土土土土土土道道树树畑畑畑畑畑
树树树树树树树树树树树树树树树树树树树土土土树土土道道水水水水水水水
树树树树树树树树树树树树树树树树树树树土土土土土土道道水水水水水水水
树树树树树树树树树树树树树树树树树树树土土土土土土道道水水土土土飾飾
水水水水水水水水水水水水水水水水水水水土土飾飾飾飾道道水水土土土無门
